Towards Automated Error Discovery: A Study in Conversational AI
Break the Checkbox: Challenging Closed-Style Evaluations of Cultural Alignment in LLMs
Biased Tales: Cultural and Topic Bias in Generating Children’s Stories
Large Language Models as Realistic Microservice Trace Generators
JUDGEBERT: Assessing Legal Meaning Preservation Between Sentences
QFrCoLA: a Quebec-French Corpus of Linguistic Acceptability Judgments
Revisiting LLM Value Probing Strategies: Are They Robust and Expressive?
A Systematic Analysis of Base Model Choice for Reward Modeling
Comparing Specialised Small and General Large Language Models on Text Classification: 100 Labelled Samples to Achieve Break-Even Performance
Is the Top Still Spinning? Evaluating Subjectivity in Narrative Understanding
MathTutorBench: A Benchmark for Measuring Open-ended Pedagogical Capabilities of LLM Tutors
Preemptive Detection and Correction of Misaligned Actions in LLM Agents
Fingerprinting LLMs through Survey Item Factor Correlation: A Case Study on Humor Style Questionnaire
Gradient-Attention Guided Dual-Masking Synergetic Framework for Robust Text-based Person Retrieval
From Problem-Solving to Teaching Problem-Solving: Aligning LLMs with Pedagogy using Reinforcement Learning
CompKBQA: Component-wise Task Decomposition for Knowledge Base Question Answering
Permutative Preference Alignment from Listwise Ranking of Human Judgments
ToneCraft: Cantonese Lyrics Generation with Harmony of Tones and Pitches
SensorLLM: Aligning Large Language Models with Motion Sensors for Human Activity Recognition
MixLoRA-DSI: Dynamically Expandable Mixture-of-LoRA Experts for Rehearsal-Free Generative Retrieval over Dynamic Corpora
ViClaim: A Multilingual Multilabel Dataset for Automatic Claim Detection in Videos
DeepResearcher: Scaling Deep Research via Reinforcement Learning in Real-world Environments
Mixture of Length and Pruning Experts for Knowledge Graphs Reasoning
MPRF: Interpretable Stance Detection through Multi-Path Reasoning Framework
Analyzing the Effects of Supervised Fine-Tuning on Model Knowledge from Token and Parameter Levels
J$\text{I}^2$S: Joint Influence‑Aware Instruction Data Selection for Efficient Fine‑Tuning
SoundMind: RL-Incentivized Logic Reasoning for Audio-Language Models
Seeing More, Saying More: Lightweight Language Experts are Dynamic Video Token Compressors
RoT: Enhancing Table Reasoning with Iterative Row-Wise Traversals
T-MAD: Target-driven Multimodal Alignment for Stance Detection
Emotion Transfer with Enhanced Prototype for Unseen Emotion Recognition in Conversation
PBI-Attack: Prior-Guided Bimodal Interactive Black-Box Jailbreak Attack for Toxicity Maximization
Training a Utility-based Retriever Through Shared Context Attribution for Retrieval-Augmented Language Models
SportReason: Evaluating Retrieval-Augmented Reasoning across Tables and Text for Sports Question Answering
MAC-Tuning: LLM Multi-Compositional Problem Reasoning with Enhanced Knowledge Boundary Awareness
CODI: Compressing Chain-of-Thought into Continuous Space via Self-Distillation
PAFT: Prompt-Agnostic Fine-Tuning
Theorem-Validated Reverse Chain-of-Thought Problem Generation for Geometric Reasoning
TACO: Enhancing Multimodal In-context Learning via Task Mapping-Guided Sequence Configuration
Towards Controllable Speech Synthesis in the Era of Large Language Models: A Systematic Survey
Automating Steering for Safe Multimodal Large Language Models
EMNLP: Educator-role Moral and Normative Large Language Models Profiling
TracSum: A New Benchmark for Aspect-Based Summarization with Sentence-Level Traceability in Medical Domain
Context Reasoner: Incentivizing Reasoning Capability for Contextualized Privacy and Safety Compliance via Reinforcement Learning
Towards General-Domain Word Sense Disambiguation: Distilling Large Language Model into Compact Disambiguator
SLoW: Select Low-frequency Words! Automatic Dictionary Selection for Translation on Large Language Models
Parallel Continuous Chain-of-Thought with Jacobi Iteration
EQA-RM: A Generative Embodied Reward Model with Test-time Scaling
Refusal-Aware Red Teaming: Exposing Inconsistency in Safety Evaluations
OmniThink: Expanding Knowledge Boundaries in Machine Writing through Thinking
LinkAlign: Scalable Schema Linking for Real-World Large-Scale Multi-Database Text-to-SQL
On Relation-Specific Neurons in Large Language Models
IPIGuard: A Novel Tool Dependency Graph-Based Defense Against Indirect Prompt Injection in LLM Agents
ProtoVQA: An Adaptable Prototypical Framework for Explainable Fine-Grained Visual Question Answering
SEA: Supervised Embedding Alignment for Token-Level Visual-Textual Integration in MLLMs
Molecular String Representation Preferences in Pretrained LLMs: A Comparative Study in Zero- & Few-Shot Molecular Property Prediction
Weight-Aware Activation Sparsity with Constrained Bayesian Optimization Scheduling for Large Language Models
DatawiseAgent: A Notebook-Centric LLM Agent Framework for Adaptive and Robust Data Science Automation
VC4VG: Optimizing Video Captions for Text-to-Video Generation
LaMP-QA: A Benchmark for Personalized Long-form Question Answering
The LLM Already Knows: Estimating LLM-Perceived Question Difficulty via Hidden Representations
MCIP: Protecting MCP Safety via Model Contextual Integrity Protocol
SAKI-RAG: Mitigating Context Fragmentation in Long-Document RAG via Sentence-level Attention Knowledge Integration
Skeletons Matter: Dynamic Data Augmentation for Text-to-Query
CondenseLM: LLMs-driven Text Dataset Condensation via Reward Matching
MovieCORE: COgnitive REasoning in Movies
Think Wider, Detect Sharper: Reinforced Reference Coverage for Document-Level Self-Contradiction Detection
DRISHTIKON: A Multimodal Multilingual Benchmark for Testing Language Models’ Understanding on Indian Culture
Learning from Few Samples: A Novel Approach for High-Quality Malcode Generation
Personality Matters: User Traits Predict LLM Preferences in Multi-Turn Collaborative Tasks
VisualWebInstruct: Scaling up Multimodal Instruction Data through Web Search
Thinking Out Loud: Do Reasoning Models Know When They’re Right?
Seeing is Believing, but How Much? A Comprehensive Analysis of Verbalized Calibration in Vision-Language Models
Enhancing Efficiency and Exploration in Reinforcement Learning for LLMs
LLM Bias Detection and Mitigation through the Lens of Desired Distributions
MEBench: Benchmarking Large Language Models for Cross-Document Multi-Entity Question Answering
POSITION BIAS MITIGATES POSITION BIAS: Mitigate Position Bias Through Inter-Position Knowledge Distillation
MMLU-ProX: A Multilingual Benchmark for Advanced Large Language Model Evaluation
NL-Debugging: Exploiting Natural Language as an Intermediate Representation for Code Debugging
Persuasion Dynamics in LLMs: Investigating Robustness and Adaptability in Knowledge and Safety with DuET-PD
POINTS-Reader: Distillation-Free Adaptation of Vision-Language Models for Document Conversion
Large Language Models for Automated Literature Review: An Evaluation of Reference Generation, Abstract Writing, and Review Composition
CoBia: Constructed Conversations Can Trigger Otherwise Concealed Societal Biases in LLMs
From Schema to State: Zero-Shot Scheme-Only Dialogue State Tracking via Diverse Synthetic Dialogue and Step-by-Step Distillation
Beyond the Surface: Measuring Self-Preference in LLM Judgments
Beyond Input Activations: Identifying Influential Latents by Gradient Sparse Autoencoders
Utility-Focused LLM Annotation for Retrieval and Retrieval-Augmented Generation
CiteBART: Learning to Generate Citations for Local Citation Recommendation
Culture Cartography: Mapping the Landscape of Cultural Knowledge
Interpretability Analysis of Arithmetic In-Context Learning in Large Language Models
SwarmAgentic: Towards Fully Automated Agentic System Generation via Swarm Intelligence
We Politely Insist: Your LLM Must Learn the Persian Art of Taarof
Unstructured Evidence Attribution for Long Context Query Focused Summarization
RAVEN: Query-Guided Representation Alignment for Question Answering over Audio, Video, Embedded Sensors, and Natural Language
Cache-of-Thought: Master-Apprentice Framework for Cost-Effective Vision Language Model Reasoning
Video Compression Commander: Plug-and-Play Inference Acceleration for Video Large Language Models
Router-Tuning: A Simple and Effective Approach for Dynamic Depth
Foot-In-The-Door: A Multi-turn Jailbreak for LLMs
TurnaboutLLM: A Deductive Reasoning Benchmark from Detective Games
Transferable Direct Prompt Injection via Activation-Guided MCMC Sampling
Direct Judgement Preference Optimization
WebInject: Prompt Injection Attack to Web Agents
F²Bench: An Open-ended Fairness Evaluation Benchmark for LLMs with Factuality Considerations
Value Profiles for Encoding Human Variation
Language Models as Causal Effect Generators
Constructions are Revealed in Word Distributions
CodeMixBench: Evaluating Code-Mixing Capabilities of LLMs Across 18 Languages
RBPtool: A Deep Language Model Framework for Multi-Resolution RBP-RNA Binding Prediction and RNA Molecule Design
Unveiling Internal Reasoning Modes in LLMs: A Deep Dive into Latent Reasoning vs. Factual Shortcuts with Attribute Rate Ratio
SAE-SSV: Supervised Steering in Sparse Representation Spaces for Reliable Control of Language Models
BabyLM’s First Constructions: Causal interventions provide a signal of learning
Effective Red-Teaming of Policy-Adherent Agents
CondAmbigQA: A Benchmark and Dataset for Conditional Ambiguous Question Answering
SafeScientist: Enhancing AI Scientist Safety for Risk-Aware Scientific Discovery
Improving Informally Romanized Language Identification
Integral Transformer: Denoising Attention, Not Too Much Not Too Little
CHENGYU-BENCH: Benchmarking Large Language Models for Chinese Idiom Understanding and Use
Improving Cross Lingual Transfer by Pretraining with Active Forgetting
Re-Align: Aligning Vision Language Models via Retrieval-Augmented Direct Preference Optimization
To Mask or to Mirror: Human-AI Alignment in Collective Reasoning
SWAN: An Efficient and Scalable Approach for Long-Context Language Modeling
LLMs Behind the Scenes: Enabling Narrative Scene Illustration
REARANK: Reasoning Re-ranking Agent via Reinforcement Learning
Large Language Models Do Multi-Label Classification Differently
FilBench: Can LLMs Understand and Generate Filipino?
M-ABSA: A Multilingual Dataset for Aspect-Based Sentiment Analysis
RuCCoD: Towards Automated ICD Coding in Russian
Code to Think, Think to Code: A Survey on Code-Enhanced Reasoning and Reasoning-Driven Code Intelligence in LLMs
Efficient Model Development through Fine-tuning Transfer
Language Mixing in Reasoning Language Models: Patterns, Impact, and Internal Causes
User Feedback in Human-LLM Dialogues: A Lens to Understand Users But Noisy as a Learning Signal
Read to Hear: A Zero-Shot Pronunciation Assessment Using Textual Descriptions and LLMs
COCO-Tree: Compositional Hierarchical Concept Trees for Enhanced Reasoning in Vision-Language Models
SurveyGen: Quality-Aware Scientific Survey Generation with Large Language Models
VoiceCraft-X: Unifying Multilingual, Voice-Cloning Speech Synthesis and Speech Editing
From Generation to Judgment: Opportunities and Challenges of LLM-as-a-judge
MultiMatch: Multihead Consistency Regularization Matching for Semi-Supervised Text Classification
TTT-Bench: A Benchmark for Evaluating Reasoning Ability with Simple and Novel Tic-Tac-Toe-style Games
Learning from Diverse Reasoning Paths with Routing and Collaboration
Ask Patients with Patience: Enabling LLMs for Human-Centric Medical Dialogue with Grounded Reasoning
MedHallu: A Comprehensive Benchmark for Detecting Medical Hallucinations in Large Language Models
NUTMEG: Separating Signal From Noise in Annotator Disagreement
Alignment Quality Index (AQI) : Beyond Refusals: AQI as an Intrinsic Alignment Diagnostic via Latent Geometry, Cluster Divergence, and Layer wise Pooled Representations
MythTriage: Scalable Detection of Opioid Use Disorder Myths on a Video-Sharing Platform
Demystifying optimized prompts in language models
Whisper-UT: A Unified Translation Framework for Speech and Text
Unleashing the Reasoning Potential of LLMs by Critique Fine-Tuning on One Problem
Active Layer-Contrastive Decoding Reduces Hallucination in Large Language Model Generation
BBScoreV2: Learning Time-Evolution and Latent Alignment from Stochastic Representation
SAND: Boosting LLM Agents with Self-Taught Action Deliberation
LLMs as World Models: Data-Driven and Human-Centered Pre-Event Simulation for Disaster Impact Assessment
Two Heads Are Better Than One: Dual-Model Verbal Reflection at Inference-Time
Image Embedding Sampling Method for Diverse Captioning
Diagnosing Memorization in Chain-of-Thought Reasoning, One Token at a Time
FANS: Formal Answer Selection for LLM Natural Language Math Reasoning Using Lean4
Date Fragments: A Hidden Bottleneck of Tokenization for Temporal Reasoning
Measuring Risk of Bias in Biomedical Reports: The RoBBR Benchmark
SHIFT: Selected Helpful Informative Frame for Video-guided Machine Translation
Surge: On the Potential of Large Language Models as General-Purpose Surrogate Code Executors
Few-Shot Learning Translation from New Languages
Humanizing Machines: Rethinking LLM Anthropomorphism Through a Multi-Level Framework of Design
TokenSkip: Controllable Chain-of-Thought Compression in LLMs
Are Generative Models Underconfident? Better Quality Estimation with Boosted Model Probability
reWordBench: Benchmarking and Improving the Robustness of Reward Models with Transformed Inputs
Why Do Some Inputs Break Low-Bit LLM Quantization?
LiteASR: Efficient Automatic Speech Recognition with Low-Rank Approximation
AROMA: Autonomous Rank-one Matrix Adaptation
Large Language Models Have Intrinsic Meta-Cognition, but Need a Good Lens
Anchoring-Guidance Fine-Tuning (AnGFT): Elevating Professional Response Quality in Role-Playing Conversational Agents
RiTTA: Modeling Event Relations in Text-to-Audio Generation
Shallow Focus, Deep Fixes: Enhancing Shallow Layers Vision Attention Sinks to Alleviate Hallucination in LVLMs
WangchanThaiInstruct: An instruction-following Dataset for Culture-Aware, Multitask, and Multi-domain Evaluation in Thai
MemeReaCon: Probing Contextual Meme Understanding in Large Vision-Language Models
A Comprehensive Literary Chinese Reading Comprehension Dataset with an Evidence Curation Based Solution
Dialect-SQL: An Adaptive Framework for Bridging the Dialect Gap in Text-to-SQL
FinMTEB: Finance Massive Text Embedding Benchmark
Scaling Rich Style-Prompted Text-to-Speech Datasets
Exploring Changes in Nation Perception with Nationality-Assigned Personas in LLMs
Eliciting Implicit Acoustic Styles from Open-domain Instructions to Facilitate Fine-grained Controllable Generation of Speech
OBLIVIATE: Robust and Practical Machine Unlearning for Large Language Models
AdaptThink: Reasoning Models Can Learn When to Think
T$^2$: An Adaptive Test-Time Scaling Strategy for Contextual Question Answering
Non-Existent Relationship: Fact-Aware Multi-Level Machine-Generated Text Detection
Calibrating Verbal Uncertainty as a Linear Feature to Reduce Hallucinations
JUREX-4E: Juridical Expert-Annotated Four-Element Knowledge Base for Legal Reasoning
CIE: Controlling Language Model Text Generations Using Continuous Signals
Stand on The Shoulders of Giants: Building JailExpert from Previous Attack Experience
Language-to-Space Programming for Training-Free 3D Visual Grounding
RAG-Instruct: Boosting LLMs with Diverse Retrieval-Augmented Instructions
AdaRewriter: Unleashing the Power of Prompting-based Conversational Query Reformulation via Test-Time Adaptation
SmartBench: Is Your LLM Truly a Good Chinese Smartphone Assistant?
F2TEval: Human-Aligned Multi-Dimensional Evaluation for Figure-to-Text Task
Icon$^2$: Aligning Large Language Models Using Self-Synthetic Preference Data via Inherent Regulation
DSCD: Large Language Model Detoxification with Self-Constrained Decoding
From Reasoning to Answer: Empirical, Attention-Based and Mechanistic Insights into Distilled DeepSeek R1 Models
Quantifying Language Disparities in Multilingual Large Language Models
KoBLEX: Open Legal Question Answering with Multi-hop Reasoning
End-to-End Learnable Psychiatric Scale Guided Risky Post Screening for Depression Detection on Social Media
ReAgent: Reversible Multi-Agent Reasoning for Knowledge-Enhanced Multi-Hop QA
Matter-of-Fact: A Benchmark for Verifying the Feasibility of Literature-Supported Claims in Materials Science
ModRWKV: Transformer Multimodality in Linear Time
Multimedia Event Extraction with LLM Knowledge Editing
Exploring the Impact of Personality Traits on LLM Toxicity and Bias
Task-aware Contrastive Mixture of Experts for Quadruple Extraction in Conversations with Code-like Replies and Non-opinion Detection
Mitigating Biases in Language Models via Bias Unlearning
UNComp: Can Matrix Entropy Uncover Sparsity? — A Compressor Design from an Uncertainty-Aware Perspective
Superpose Task-specific Features for Model Merging
FinRAGBench-V: A Benchmark for Multimodal RAG with Visual Citation in the Financial Domain
BacktrackAgent: Enhancing GUI Agent with Error Detection and Backtracking Mechanism
Diffusion vs. Autoregressive Language Models: A Text Embedding Perspective
BannerAgency: Advertising Banner Design with Multimodal LLM Agents
DIDS: Domain Impact-aware Data Sampling for Large Language Model Training
Training LLMs to be Better Text Embedders through Bidirectional Reconstruction
ReMedy: Learning Machine Translation Evaluation from Human Preferences with Reward Modeling
SolEval: Benchmarking Large Language Models for Repository-level Solidity Smart Contract Generation
In-Context Learning Boosts Speech Recognition via Human-like Adaptation to Speakers and Language Varieties
Reasoning Model Unlearning: Forgetting Traces, Not Just Answers, While Preserving Reasoning Skills
Chain-of-Talkers (CoTalk): Fast Human Annotation of Dense Image Captions
DecoupleSearch: Decouple Planning and Search via Hierarchical Reward Modeling
RewardDS: Privacy-Preserving Fine-Tuning for Large Language Models via Reward Driven Data Synthesis
Synergizing Multimodal Temporal Knowledge Graphs and Large Language Models for Social Relation Recognition
LegalSearchLM: Rethinking Legal Case Retrieval as Legal Elements Generation
ChartMind: A Comprehensive Benchmark for Complex Real-world Multimodal Chart Question Answering
COLA: Collaborative Multi-Agent Framework with Dynamic Task Scheduling for GUI Automation
DASA-Trans-STM: Adaptive Efficient Transformer for Short Text Matching using Data Augmentation and Semantic Awareness
Pruning the Paradox: How CLIP’s Most Informative Heads Enhance Performance While Amplifying Bias
CoLA: Compute-Efficient Pre-Training of LLMs via Low-Rank Activation
TS-CLIP: Time Series Understanding by CLIP
MultiAgentESC: A LLM-based Multi-Agent Collaboration Framework for Emotional Support Conversation
Continuously Steering LLMs Sensitivity to Contextual Knowledge with Proxy Models
Probing LLM World Models: Enhancing Guesstimation with Wisdom of Crowds Decoding
Recall with Reasoning: Chain-of-Thought Distillation for Mamba’s Long-Context Memory and Extrapolation
Scalable Data Synthesis through Human-like Cognitive Imitation and Data Recombination
BeSimulator: A Large Language Model Powered Text-based Behavior Simulator
Too Consistent to Detect: A Study of Self-Consistent Errors in LLMs
pFedGPT: Hierarchically Optimizing LoRA Aggregation Weights for Personalized Federated GPT Models
QSpec: Speculative Decoding with Complementary Quantization Schemes
Co-Evolving LLMs and Embedding Models via Density-Guided Preference Optimization for Text Clustering
P-MMEval: A Parallel Multilingual Multitask Benchmark for Consistent Evaluation of LLMs
Single LLM, Multiple Roles: A Unified Retrieval-Augmented Generation Framework Using Role-Specific Token Optimization
TrInk: Ink Generation with Transformer Network
CalligraphicOCR for Chinese Calligraphy Recognition
When Audio and Text Disagree: Revealing Text Bias in Large Audio-Language Models
RESF: Regularized-Entropy-Sensitive Fingerprinting for Black-Box Tamper Detection of Large Language Models
Model-based Large Language Model Customization as Service
Collab-Overcooked: Benchmarking and Evaluating Large Language Models as Collaborative Agents
Improving Reasoning Capabilities in Small Models through Mixture-of-layers Distillation with Stepwise Attention on Key Information
Through the Valley: Path to Effective Long CoT Training for Small Language Models
RED: Unleashing Token-Level Rewards from Holistic Feedback via Reward Redistribution
SDGO: Self-Discrimination-Guided Optimization for Consistent Safety in Large Language Models
InMind: Evaluating LLMs in Capturing and Applying Individual Human Reasoning Styles
MIO: A Foundation Model on Multimodal Tokens
DART: Distilling Autoregressive Reasoning to Silent Thought
LeTS: Learning to Think-and-Search via Process-and-Outcome Reward Hybridization
CYCLE-INSTRUCT: Fully Seed-Free Instruction Tuning via Dual Self-Training and Cycle Consistency
Good Intentions Beyond ACL: Who Does NLP for Social Good, and Where?
From General Reward to Targeted Reward: Improving Open-ended Long-context Generation Models
Think in Safety: Unveiling and Mitigating Safety Alignment Collapse in Multimodal Large Reasoning Model
Understanding the Modality Gap: An Empirical Study on the Speech-Text Alignment Mechanism of Large Speech Language Models
AssoCiAm: A Benchmark for Evaluating Association Thinking while Circumventing Ambiguity
M-BRe: Discovering Training Samples for Relation Extraction from Unlabeled Texts with Large Language Models
R-TOFU: Unlearning in Large Reasoning Models
Chat-Driven Text Generation and Interaction for Person Retrieval
Spontaneous Giving and Calculated Greed in Language Models
SenDetEX: Sentence-Level AI-Generated Text Detection for Human-AI Hybrid Content via Style and Context Fusion
Judge and Improve: Towards a Better Reasoning of Knowledge Graphs with Large Language Models
Add-One-In: Incremental Sample Selection for Large Language Models via a Choice-Based Greedy Paradigm
QuZO: Quantized Zeroth-Order Fine-Tuning for Large Language Models
Cost-Optimal Grouped-Query Attention for Long-Context Modeling
ChatVLA: Unified Multimodal Understanding and Robot Control with Vision-Language-Action Model
KG-RAG: Enhancing GUI Agent Decision-Making via Knowledge Graph-Driven Retrieval-Augmented Generation
CLIP-MoE: Towards Building Mixture of Experts for CLIP with Diversified Multiplet Upcycling
Search-o1: Agentic Search-Enhanced Large Reasoning Models
From Personas to Talks: Revisiting the Impact of Personas on LLM-Synthesized Emotional Support Conversations
Select-Then-Decompose: From Empirical Analysis to Adaptive Selection Strategy for Task Decomposition in Large Language Models
TombRaider: Entering the Vault of History to Jailbreak Large Language Models
Text Meets Topology: Rethinking Out-of-distribution Detection in Text-Rich Networks
APLOT: Robust Reward Modeling via Adaptive Preference Learning with Optimal Transport
HS-STaR: Hierarchical Sampling for Self-Taught Reasoners via Difficulty Estimation and Budget Reallocation
SEPS: A Separability Measure for Robust Unlearning in LLMs
TRUST-VL: An Explainable News Assistant for General Multimodal Misinformation Detection
Tree-of-Quote Prompting Improves Factuality and Attribution in Multi-Hop and Medical Reasoning
UnitCoder: Scalable Code Synthesis from Pre-training Corpora
GRPO-LEAD: A Difficulty-Aware Reinforcement Learning Approach for Concise Mathematical Reasoning in Language Models
Improving Low-Resource Sequence Labeling with Knowledge Fusion and Contextual Label Explanations
Rethinking Cross-Subject Data Splitting for Brain-to-Text Decoding
RCScore: Quantifying Response Consistency in Large Language Models
A Multi-Agent Framework with Automated Decision Rule Optimization  for Cross-Domain Misinformation Detection
OmniEval: An Omnidirectional and Automatic RAG Evaluation Benchmark in Financial Domain
AQuilt: Weaving Logic and Self-Inspection into Low-Cost, High-Relevance Data Synthesis for Specialist LLMs
MoSEs: Uncertainty-Aware AI-Generated Text Detection via Mixture of Stylistics Experts with Conditional Thresholds
Merger-as-a-Stealer: Stealing Targeted PII from Aligned LLMs with Model Merging
Pragmatic Inference Chain (PIC) Improving LLMs’ Reasoning of Authentic Implicit Toxic Language
Beyond Demonstrations: Dynamic Vector Construction from Latent Representations
Detoxifying Large Language Models via the Diversity of Toxic Samples
LLM-Driven Implicit Target Augmentation and Fine-Grained Contextual Modeling for Zero-Shot and Few-Shot Stance Detection
Dial-In LLM: Human-Aligned LLM-in-the-loop Intent Clustering for Customer Service Dialogues
Superficial Self-Improved Reasoners Benefit from Model Merging
CARFT: Boosting LLM Reasoning via Contrastive Learning with Annotated Chain-of-Thought-based Reinforced Fine-Tuning
QualBench: Benchmarking Chinese LLMs with Localized Professional Qualifications for Vertical Domain Evaluation
VideoEraser: Concept Erasure in Text-to-Video Diffusion Models
Diagram-Driven Course Questions Generation
ECC: An Emotion-Cause Conversation Dataset for Empathy Response
ThoughtProbe: Classifier-Guided LLM Thought Space Exploration via Probing Representations
JOLT-SQL: Joint Loss Tuning of Text-to-SQL with Confusion-aware Noisy Schema Sampling
DMDTEval: An Evaluation and Analysis of LLMs on Disambiguation in Multi-domain Translation
SciRIFF: A Resource to Enhance Language Model Instruction-Following over Scientific Literature
MAKAR: a Multi-Agent framework based Knowledge-Augmented Reasoning for Grounded Multimodal Named Entity Recognition
VisCRA: A Visual Chain Reasoning Attack for Jailbreaking Multimodal Large Language Models
Investigating Neurons and Heads in Transformer-based LLMs for Typographical Errors
LMR-BENCH: Evaluating LLM Agent’s Ability on Reproducing Language Modeling Research
RAV: Retrieval-Augmented Voting for Tactile Descriptions Without Training
Static Word Embeddings for Sentence Semantic Representation
PropRAG: Guiding Retrieval with Beam Search over Proposition Paths
Rethinking Backdoor Detection Evaluation for Language Models
Glider: Global and Local Instruction-Driven Expert Router
CoVoGER: A Multilingual Multitask Benchmark for Speech-to-text Generative Error Correction with Large Language Models
Tiny Budgets, Big Gains: Parameter Placement Strategy in Parameter Super-Efficient Fine-Tuning
Legal Fact Prediction: The Missing Piece in Legal Judgment Prediction
DAMON: A Dialogue-Aware MCTS Framework for Jailbreaking Large Language Models
Multilingual Prompting for Improving LLM Generation Diversity
MOSAIC: Modeling Social AI for Content Dissemination and Regulation in Multi-Agent Simulations
Identification of Multiple Logical Interpretations in Counter-Arguments
LyapLock: Bounded Knowledge Preservation in Sequential Large Language Model Editing
AlignX: Advancing Multilingual Large Language Models with Multilingual Representation Alignment
What Makes a Good Reasoning Chain? Uncovering Structural Patterns in Long Chain-of-Thought Reasoning
HD-PiSSA: High-Rank Distributed Orthogonal Adaptation
Firewall Routing: Blocking Leads to Better Hybrid Inference for LLMs
SPE Attention: Making Attention Equivariant to Semantic-Preserving Permutation for Code Processing
Audio-centric Video Understanding Benchmark without Text Shortcut
TurboRAG: Accelerating Retrieval-Augmented Generation with Precomputed KV Caches for Chunked Text
ZoomEye: Enhancing Multimodal LLMs with Human-Like Zooming Capabilities through Tree-Based Image Exploration
Learning Like Humans: Advancing LLM Reasoning Capabilities via Adaptive Difficulty Curriculum Learning and Expert-Guided Self-Reformulation
VersaTune: An Efficient Data Composition Framework for Training Multi-Capability LLMs
FlightGPT: Towards Generalizable and Interpretable UAV Vision-and-Language Navigation with Vision-Language Models
Multimodal Language Models See Better When They Look Shallower
LoSiA: Efficient High-Rank Fine-Tuning via Subnet Localization and Optimization
Invisible Entropy: Towards Safe and Efficient Low-Entropy LLM Watermarking
Measuring Bias or Measuring the Task: Understanding the Brittle Nature of LLM Gender Biases
Alignment-Augmented Speculative Decoding with Alignment Sampling and Conditional Verification
ViLBench: A Suite for Vision-Language Process Reward Modeling
Keep Security! Benchmarking Security Policy Preservation in Large Language Model Contexts Against Indirect Attacks in Question Answering
Route Sparse Autoencoder to Interpret Large Language Models
BTS: Harmonizing Specialized Experts into a Generalist LLM
CoCoA: Confidence- and Context-Aware Adaptive Decoding for Resolving Knowledge Conflicts in Large Language Models
R-Bind: Unified Enhancement of Attribute and Relation Binding in Text-to-Image Diffusion Models
Middo: Model-Informed Dynamic Data Optimization for Enhanced LLM Fine-Tuning via Closed-Loop Learning
Information Integration in Large Language Models is Gated by Linguistic Structural Markers
Why and How LLMs Benefit from Knowledge Introspection in Commonsense Reasoning
GraDaSE: Graph-Based Dataset Search with Examples
Confidence-guided Refinement Reasoning for Zero-shot Question Answering
DICE: Structured Reasoning in LLMs through SLM-Guided Chain-of-Thought Correction
CTCC: A Robust and Stealthy Fingerprinting Framework for Large Language Models via Cross-Turn Contextual Correlation Backdoor
Realistic Training Data Generation and Rule Enhanced Decoding in LLM for NameGuess
EverTracer: Hunting Stolen Large Language Models via Stealthy and Robust Probabilistic Fingerprint
Selective Preference Optimization via Token-Level Reward Function Estimation
Arena-lite: Efficient and Reliable Large Language Model Evaluation via Tournament-Based Direct Comparisons
Addressing Tokenization Inconsistency in Steganography and Watermarking Based on Large Language Models
ExeCoder: Empowering Large Language Models with Executability Representation for Code Translation
TableEval: A Real-World Benchmark for Complex, Multilingual, and Multi-Structured Table Question Answering
NOVA-63: Native Omni-lingual Versatile Assessments of 63 Disciplines
InfoGain-RAG: Boosting Retrieval-Augmented Generation through Document Information Gain-based Reranking and Filtering
SpecVLM: Enhancing Speculative Decoding of Video LLMs via Verifier-Guided Token Pruning
What Do Indonesians Really Need from Language Technology? A Nationwide Survey
LEO-MINI: An Efficient Multimodal Large Language Model using Conditional Token Reduction and Mixture of Multi-Modal Experts
Confounding Factors in Relating Model Performance to Morphology
Context-Aware Membership Inference Attacks against Pre-trained Large Language Models
Formalizing Style in Personal Narratives
TopicAttack: An Indirect Prompt Injection Attack via Topic Transition
PSET: a Phonetics-Semantics Evaluation Testbed
From Unaligned to Aligned: Scaling Multilingual LLMs with Multi-Way Parallel Corpora
GATEAU: Selecting Influential Samples for Long Context Alignment
Teach Small Models to Reason by Curriculum Distillation
Enhancing Reasoning Abilities of Small LLMs with Cognitive Alignment
NOVER: Incentive Training for Language Models via Verifier-Free Reinforcement Learning
Genre Matters: How Text Types Interact with Decoding Strategies and Lexical Predictors in Shaping Reading Behavior
RTE-GMoE: A Model-agnostic Approach for Relation Triplet Extraction via Graph-based Mixture-of-Expert Mutual Learning
Avoidance Decoding for Diverse Multi-Branch Story Generation
Probabilistic Soundness Guarantees in LLM Reasoning Chains
SQLWOZ: A Realistic Task-Oriented Dialogue Dataset with SQL-Based Dialogue State Representation for Complex User Requirements
SURE: Safety Understanding and Reasoning Enhancement for Multimodal Large Language Models
EMO: Embedding Model Distillation via Intra-Model Relation and Optimal Transport Alignments
AesBiasBench: Evaluating Bias and Alignment in Multimodal Language Models for Personalized Image Aesthetic Assessment
DA-Pred: Performance Prediction for Text Summarization under Domain-Shift and Instruct-Tuning
UnCo: Uncertainty-Driven Collaborative Framework of Large and Small Models for Grounded Multimodal NER
An Empirical Study of LLM Reasoning Ability Under Strict Output Length Constraint
Enrich-on-Graph: Query-Graph Alignment for Complex Reasoning with LLM Enriching
Noise, Adaptation, and Strategy: Assessing LLM Fidelity in Decision-Making
Structuring Radiology Reports: Challenging LLMs with Lightweight Models
PricingLogic: Evaluating LLMs Reasoning on Complex Tourism Pricing Tasks
EcoTune: Token-Efficient Multi-Fidelity Hyperparameter Optimization for Large Language Model Inference
Investigating Value-Reasoning Reliability in Small Large Language Models
Can LLMs Explain Themselves Counterfactually?
Self-Adjust Softmax
XAutoLM: Efficient Fine-Tuning of Language Models via Meta-Learning and AutoML
UNCERTAINTY-LINE: Length-Invariant Estimation of Uncertainty for Large Language Models
WebAgent-R1: Training Web Agents via End-to-End Multi-Turn Reinforcement Learning
Same evaluation, more tokens: On the effect of input length for machine translation evaluation using Large Language Models
PAKTON: A Multi-Agent Framework for Question Answering in Long Legal Agreements
PoSum-Bench: Benchmarking Position Bias in LLM-based Conversational Summarization
ConCISE: Confidence-guided Compression in Step-by-step Efficient Reasoning
Layer-Aware Representation Filtering: Purifying Finetuning Data to Preserve LLM Safety Alignment
Cross-domain Rumor Detection via Test-Time Adaptation and Large Language Models
MLWQ: Efficient Small Language Model Deployment via Multi-Level Weight Quantization
ToDi: Token-wise Distillation via Fine-Grained Divergence Control
RethinkMCTS: Refining Erroneous Thoughts in Monte Carlo Tree Search for Code Generation
Probing for Arithmetic Errors in Language Models
NILE: Internal Consistency Alignment in Large Language Models
Mining the Past with Dual Criteria: Integrating Three types of Historical Information for Context-aware Event Forecasting
RAGferee: Building Contextual Reward Models for Retrieval-Augmented Generation
Large Language Models Discriminate Against Speakers of German Dialects
Uncovering Argumentative Flow: A Question-Focus Discourse Structuring Framework
AbsVis – Benchmarking How Humans and Vision-Language Models “See” Abstract Concepts in Images
A Rigorous Evaluation of LLM Data Generation Strategies for Low-Resource Languages
Alignment with Fill-In-the-Middle for Enhancing Code Generation
A Middle Path for On-Premises LLM Deployment: Preserving Privacy Without Sacrificing Model Confidentiality
Variance Sensitivity Induces Attention Entropy Collapse and Instability in Transformers
X-FLoRA: Cross-modal Federated Learning with Modality-expert LoRA for Medical VQA
Robust Native Language Identification through Agentic Decomposition
ConsistentChat: Building Skeleton-Guided Consistent Multi-Turn Dialogues for Large Language Models from Scratch
Does Acceleration Cause Hidden Instability in Vision Language Models? Uncovering Instance-Level Divergence Through a Large-Scale Empirical Study
When Annotators Disagree, Topology Explains: Mapper, a Topological Tool for Exploring Text Embedding Geometry and Ambiguity
Self-Critique and Refinement for Faithful Natural Language Explanations
The Psychology of Falsehood: A Human-Centric Survey of Misinformation Detection
SEAL: Structure and Element Aware Learning Improves Long Structured Document Retrieval
AnchorAttention: Difference-Aware Sparse Attention with Stripe Granularity
Attacks by Content: Automated Fact-checking is an AI Security Issue
MUZO: Leveraging Multiple Queries and Momentum for Zeroth-Order Fine-Tuning of Large Language Models
Your Language Model Can Secretly Write Like Humans: Contrastive Paraphrase Attacks on LLM-Generated Text Detectors
Will It Still Be True Tomorrow? Multilingual Evergreen Question Classification to Improve Trustworthy QA
Steering Language Models in Multi-Token Generation: A Case Study on Tense and Aspect
DocReRank: Single-Page Hard Negative Query Generation for Training Multi-Modal RAG Rerankers
Reason to Rote: Rethinking Memorization in Reasoning
VELA: An LLM-Hybrid-as-a-Judge Approach for Evaluating Long Image Captions
LLM-Independent Adaptive RAG: Let the Question Speak for Itself
TurnBack: A Geospatial Route Cognition Benchmark for Large Language Models through Reverse Route
Certainty in Uncertainty: Reasoning over Uncertain Knowledge Graphs with Statistical Guarantees
Beyond Seen Data: Improving KBQA Generalization Through Schema-Guided Logical Form Generation
A Training-Free Length Extrapolation Approach for LLMs: Greedy Attention Logit Interpolation
Taming Text-to-Image Synthesis for Novices: User-centric Prompt Generation via Multi-turn Guidance
We Need to Measure Data Diversity in NLP — Better and Broader
Sheaf Discovery with Joint Computation Graph Pruning and Flexible Granularity
Hierarchical Bracketing Encodings Work for Dependency Graphs
Multimodal Fine-grained Context Interaction Graph Modeling for Conversational Speech Synthesis
Judging Quality Across Languages: A Multilingual Approach to Pretraining Data Filtering with Language Models
Conditional [MASK] Discrete Diffusion Language Model
Language-Guided Temporal Token Pruning for Efficient VideoLLM Processing
A Fully Probabilistic Perspective on Large Language Model Unlearning: Evaluation and Optimization
IIET: Efficient Numerical Transformer via Implicit Iterative Euler Method
WebEvolver: Enhancing Web Agent Self-Improvement with Co-evolving World Model
Leveraging Semantic Triples for Private Document Generation with Local Differential Privacy Guarantees
HVGuard: Utilizing Multimodal Large Language Models for Hateful Video Detection
Accelerate Parallelizable Reasoning via Parallel Decoding within One Sequence
SlideCoder: Layout-aware RAG-enhanced Hierarchical Slide Generation from Design
LLM-OREF: An Open Relation Extraction Framework Based on Large Language Models
Ambiguity Awareness Optimization: Towards Semantic Disambiguation for Direct Preference Optimization
Improving Multilingual Retrieval-Augmented Language Models through Dialectic Reasoning Argumentations
Predicate-Guided Generation for Mathematical Reasoning
ComplexTempQA: A 100m Dataset for Complex Temporal Question Answering
ViDoRAG: Visual Document Retrieval-Augmented Generation via Dynamic Iterative Reasoning Agents
IndoSafety: Culturally Grounded Safety for LLMs in Indonesian Languages
Can LLMs Help You at Work? A Sandbox for Evaluating LLM Agents in Enterprise Environments
Steering LLM Reasoning Through Bias-Only Adaptation
VLASCD: A Visual Language Action Model for Simultaneous Chatting and Decision Making
M-LongDoc: A Benchmark For Multimodal Super-Long Document Understanding And A Retrieval-Aware Tuning Framework
Look Again, Think Slowly: Enhancing Visual Reflection in Vision-Language Models
FB-Bench: A Fine-Grained Multi-Task Benchmark for Evaluating LLMs’ Responsiveness to Human Feedback
HYDRA: A Multi-Head Encoder-only Architecture for Hierarchical Text Classification
CARD: Cross-modal Agent Framework for Generative and Editable Residential Design
DrDiff: Dynamic Routing Diffusion with Hierarchical Attention for Breaking the Efficiency-Quality Trade-off
FaST: Feature-aware Sampling and Tuning for Personalized Preference Alignment with Limited Data
On LLM-Based Scientific Inductive Reasoning Beyond Equations
SPECS: Specificity-Enhanced CLIP-Score for Long Image Caption Evaluation
LM-Searcher: Cross-domain Neural Architecture Search with LLMs via Unified Numerical Encoding
Does quantization affect models’ performance on long-context tasks?
Token-Aware Editing of Internal Activations for Large Language Model Alignment
Bitune: Leveraging Bidirectional Attention to Improve Decoder-Only LLMs
Disambiguation in Conversational Question Answering in the Era of LLMs and Agents: A Survey
Plan Dynamically, Express Rhetorically: A Debate-Driven Rhetorical Framework for Argumentative Writing
TCPO: Thought-Centric Preference Optimization for Effective Embodied Decision-making
Reimagining Safety Alignment with An Image
Visual Contextual Attack: Jailbreaking MLLMs with Image-Driven Context Injection
Can Large Language Models Win the International Mathematical Games?
CodeArena: Evaluating and Aligning CodeLLMs on Human Preference
Language models can learn implicit multi-hop reasoning, but only if they have lots of training data
UniversalCEFR: Enabling Open Multilingual Research on Language Proficiency Assessment
CROP: Contextual Region-Oriented Visual Token Pruning
CR4-NarrEmote: An Open Vocabulary Dataset of Narrative Emotions Derived Using Citizen Science
XQuant: Achieving Ultra-Low Bit KV Cache Quantization with Cross-Layer Compression
DINT Transformer
ICR: Iterative Clarification and Rewriting for Conversational Search
Pre-training CLIP against Data Poisoning with Optimal Transport-based Matching and Alignment
Similarity = Value? Consultation Value-Assessment and Alignment for Personalized Search
RTQA : Recursive Thinking for Complex Temporal Knowledge Graph Question Answering with Large Language Models
Not All Parameters Are Created Equal: Smart Isolation Boosts Fine-Tuning Performance
AI Knows Where You Are: Exposure, Bias, and Inference in Multimodal Geolocation with KoreaGEO
CAT: Causal Attention Tuning For Injecting Fine-grained Causal Knowledge into Large Language Models
Enhancing LLM Text Detection with Retrieved Contexts and Logits Distribution Consistency
Stop Looking for ``Important Tokens’’ in Multimodal Language Models: Duplication Matters More
AgentPro: Enhancing LLM Agents with Automated Process Supervision
PORTS: Preference-Optimized Retrievers for Tool Selection with Large Language Models
MusKGC: A Flexible Multi-source Knowledge Enhancement Framework for Open-World Knowledge Graph Completion
Towards Transferable Personality Representation Learning based on Triplet Comparisons and Its Applications
Reshaping Representation Space to Balance the Safety and Over-rejection in Large Audio Language Models
Benchmarking Large Language Models Under Data Contamination: A Survey from Static to Dynamic Evaluation
FinTrust: A Comprehensive Benchmark of Trustworthiness Evaluation in Finance Domain
RecGPT: A Foundation Model for Sequential Recommendation
Towards Holistic Evaluation of Large Audio-Language Models: A Comprehensive Survey
Train One Sparse Autoencoder Across Multiple Sparsity Budgets to Preserve Interpretability and Accuracy
Learn and Unlearn: Addressing Misinformation in Multilingual LLMs
PRISM: Efficient Long-Range Reasoning With Short-Context LLMs
Augmenting Multi-Agent Communication with State Delta Trajectory
SAEs Are Good for Steering – If You Select the Right Features
CoBA: Counterbias Text Augmentation for Mitigating Various Spurious Correlations via Semantic Triples
Layered Insights: Generalizable Analysis of Human Authorial Style by Leveraging All Transformer Layers
When Long Helps Short: How Context Length in Supervised Fine-tuning Affects Behavior of Large Language Models
A Case Against Implicit Standards: Homophone Normalization in Machine Translation for Languages that use the Ge’ez Script.
Evaluating Language Translation Models by Playing Telephone
Doubling Your Data in Minutes: Ultra-fast Tabular Data Generation via LLM-Induced Dependency Graphs
SPaRC: A Spatial Pathfinding Reasoning Challenge
Primus: A Pioneering Collection of Open-Source Datasets for Cybersecurity LLM Training
Bit-Flip Error Resilience in LLMs: A Comprehensive Analysis and Defense Framework
Towards Faithful Natural Language Explanations: A Study Using Activation Patching in Large Language Models
Calibrating LLM Confidence by Probing Perturbed Representation Stability
SATER: A Self-Aware and Token-Efficient Approach to Routing and Cascading
DSG-MCTS: A Dynamic Strategy-Guided Monte Carlo Tree Search for Diversified Reasoning in Large Language Models
CIFLEX: Contextual Instruction Flow for Sub-task Execution in Multi-Turn Interactions with a Single On-Device LLM
On the Role of Model Prior in Real-World Inductive Reasoning
Viability of Machine Translation for Healthcare in Low-Resourced Languages
Latent Inter-User Difference Modeling for LLM Personalization
IG-Pruning: Input-Guided Block Pruning for Large Language Models
Are Checklists Really Useful for Automatic Evaluation of Generative Tasks?
Measuring the Effect of Disfluency in Multilingual Knowledge Probing Benchmarks
Knowledge Editing through Chain-of-Thought
SelfRACG: Enabling LLMs to Self-Express and Retrieve for Code Generation
Probing Logical Reasoning of MLLMs in Scientific Diagrams
AdamS: Momentum Itself Can Be A Normalizer for LLM Pretraining and Post-training
Demystifying Synthetic Data in LLM Pre-training: A Systematic Study of Scaling Laws, Benefits, and Pitfalls
Static or Dynamic: Towards Query-Adaptive Token Selection for Video Question Answering
DischargeSim: A Simulation Benchmark for Educational Doctor–Patient Communication at Discharge
Can Vision-Language Models Solve Visual Math Equations?
From Scores to Steps: Diagnosing and Improving LLM Performance in Evidence-Based Medical Calculations
Bridging External and Parametric Knowledge: Mitigating Hallucination of LLMs with Shared-Private Semantic Synergy in Dual-Stream Knowledge
Deep Associations, High Creativity: A Simple yet Effective Metric for Evaluating Large Language Models
Identifying Unlearned Data in LLMs via Membership Inference Attacks
Feature Extraction and Steering for Enhanced Chain-of-Thought Reasoning in Language Models
LLMs cannot spot math errors, even when allowed to peek into the solution
Can LLMs be Good Graph Judge for Knowledge Graph Construction?
NeuroAda: Activating Each Neuron’s Potential for Parameter-Efficient Fine-Tuning
NileChat: Towards Linguistically Diverse and Culturally Aware LLMs for Local Communities
A Computational Simulation of Language Production in First Language Acquisition
Long-Form Information Alignment Evaluation Beyond Atomic Facts
Voice of a Continent: Mapping Africa’s Speech Technology Frontier
Cache-Efficient Posterior Sampling for Reinforcement Learning with LLM-Derived Priors Across Discrete and Continuous Domains
Circuit Complexity Bounds for RoPE-based Transformer Architecture
Efficient Unstructured Pruning of Mamba State-Space Models for Resource-Constrained Environments
Towards Infinite-Long Prefix in Transformer
LATTE: Learning to Think with Vision Specialists
SUA: Stealthy Multimodal Large Language Model Unlearning Attack
ResFormer: All-Time Reservoir Memory for Long Sequence Classification
Back Attention: Understanding and Enhancing Multi-Hop Reasoning in Large Language Models
Interdisciplinary Research in Conversation: A Case Study in Computational Morphology for Language Documentation
Analyzing Uncertainty of LLM-as-a-Judge: Interval Evaluations with Conformal Prediction
AlphaOne: Reasoning Models Thinking Slow and Fast at Test Time
Dual-Path Dynamic Fusion with Learnable Query for Multimodal Sentiment Analysis
CaKE: Circuit-aware Editing Enables Generalizable Knowledge Learners
DEL-ToM: Inference-Time Scaling for Theory-of-Mind Reasoning via Dynamic Epistemic Logic
Collaborative Beam Search: Enhancing LLM Reasoning via Collective Consensus
Deriving Strategic Market Insights with Large Language Models: A Benchmark for Forward Counterfactual Generation
Towards Statistical Factuality Guarantee for Large Vision-Language Models
Unlearning vs. Obfuscation: Are We Truly Removing Knowledge?
Reward-Shifted Speculative Sampling Is An Efficient Test-Time Weak-to-Strong Aligner
Stimulate the Critical Thinking of LLMs via Debiasing Discussion
Toward Multi-Session Personalized Conversation: A Large-Scale Dataset and Hierarchical Tree Framework for Implicit Reasoning
Improving Instruct Models for Free: A Study on Partial Adaptation
CoMMIT: Coordinated Multimodal Instruction Tuning
Meta-Rewarding Language Models: Self-Improving Alignment with LLM-as-a-Meta-Judge
AnyMAC: Cascading Flexible Multi-Agent Collaboration via Next-Agent Prediction
A Good Plan is Hard to Find: Aligning Models with Preferences is Misaligned with What Helps Users
Words Like Knives: Backstory-Personalized Modeling and Detection of Violent Communication
Separate the Wheat from the Chaff: Winnowing Down Divergent Views in Retrieval Augmented Generation
Cognitive Linguistic Identity Fusion Score (CLIFS): A Scalable Cognition‑Informed Approach to Quantifying Identity Fusion from Text
SilVar: Speech-Driven Multimodal Model for Reasoning Visual Question Answering and Object Localization
CEMTM: Contextual Embedding-based Multimodal Topic Modeling
RedHerring Attack: Testing the Reliability of Attack Detection
Modeling Bottom-up Information Quality during Language Processing
Data Drives Unstable Hierarchical Generalization in LMs
EmoAgent: Assessing and Safeguarding Human-AI Interaction for Mental Health Safety
Polysemantic Dropout: Conformal OOD Detection for Specialized LLMs
Facilitating Cognitive Accessibility with LLMs: A Multi-Task Approach to Easy-to-Read Text Generation
D-CoDe: Scaling Image-Pretrained VLMs to Video via Dynamic Compression and Question Decomposition
ReEvalMed: Rethinking Medical Report Evaluation by Aligning Metrics with Real-World Clinical Judgment
MultiMed-ST: Large-scale Many-to-many Multilingual Medical Speech Translation
Beyond Checkmate: Exploring the Creative Choke Points for AI Generated Texts
MoR: Better Handling Diverse Queries with a Mixture of Sparse, Dense, and Human Retrievers
Learning Contextual Retrieval for Robust Conversational Search
LIDDIA: Language-based Intelligent Drug Discovery Agent
Agentic-R1: Distilled Dual-Strategy Reasoning
Proactive Assistant Dialogue Generation from Streaming Egocentric Videos
Should I Share this Translation? Evaluating Quality Feedback for User Reliance on Machine Translation
ChartGaze: Enhancing Chart Understanding in LVLMs with Eye-Tracking Guided Attention Refinement
LogiCoL: Logically-Informed Contrastive Learning for Set-based Dense Retrieval
ModalPrompt: Towards Efficient Multimodal Continual Instruction Tuning with Dual-Modality Guided Prompt
Skip-Thinking: Chunk-wise Chain-of-Thought Distillation Enable Smaller Language Models to Reason Better and Faster
Can an Individual Manipulate the Collective Decisions of Multi-Agents?
Toxicity Red-Teaming: Benchmarking LLM Safety in Singapore’s Low-Resource Languages
Improving Clustering with Positive Pairs Generated from LLM-Driven Labels
Gamma-Guard: Lightweight Residual Adapters for Robust Guardrails in Large Language Models
Facilitating Long Context Understanding via Supervised Chain-of-Thought Reasoning
Dynamic Energy-Based Contrastive Learning with Multi-Stage Knowledge Verification for Event Causality Identification
ICG: Improving Cover Image Generation via MLLM-based Prompting and Personalized Preference Alignment
From Long to Lean: Performance-aware and Adaptive Chain-of-Thought Compression via Multi-round Refinement
A Symbolic Adversarial Learning Framework for Evolving Fake News Generation and Detection
RareSyn: Health Record Synthesis for Rare Disease Diagnosis
Sticker-TTS: Learn to Utilize Historical Experience with a Sticker-driven Test-Time Scaling Framework
CMHG: A Dataset and Benchmark for Headline Generation of Minority Languages in China
Understanding the Information Propagation Effects of Communication Topologies in LLM-based Multi-Agent Systems
Boosting Data Utilization for Multilingual Dense Retrieval
Self-Augmented Preference Alignment for Sycophancy Reduction in LLMs
TP-RAG: Benchmarking Retrieval-Augmented Large Language Model Agents for Spatiotemporal-Aware Travel Planning
Recontextualizing Revitalization: A Mixed Media Approach to Reviving the Nüshu Language
Towards Advanced Mathematical Reasoning for LLMs via First-Order Logic Theorem Proving
From Tens of Hours to Tens of Thousands: Scaling Back-Translation for Speech Recognition
CityEQA: A Hierarchical LLM Agent on Embodied Question Answering Benchmark in City Space
Mitigating Hallucinations in Vision-Language Models through Image-Guided Head Suppression
Examining False Positives under Inference Scaling for Mathematical Reasoning
Translationese-index: Using Likelihood Ratios for Graded and Generalizable Measurement of Translationese
Exploring the Limitations of Mamba in COPY and CoT Reasoning
ProcWorld: Benchmarking Large Model Planning in Reachability-Constrained Environments
R2I-Bench: Benchmarking Reasoning-Driven Text-to-Image Generation
Can GRPO Boost Complex Multimodal Table Understanding?
MoMoE: Mixture of Moderation Experts Framework for AI-Assisted Online Governance
Following the Autoregressive Nature of LLM Embeddings via Compression and Alignment
Evaluating LLM-Generated Diagrams as Graphs
Breaking Bad Tokens: Detoxification of LLMs Using Sparse Autoencoders
VCSearch: Bridging the Gap Between Well-Defined and Ill-Defined Problems in Mathematical Reasoning
How do autoregressive transformers solve full addition?
MAIN: Mutual Alignment Is Necessary for instruction tuning
Expanding before Inferring: Enhancing Factuality in Large Language Models through Premature Layers Interpolation
DeepWell-Adol: A Scalable Expert-Based Dialogue Corpus for Adolescent Positive Mental Health and Wellbeing Promotion
Data to Defense: The Role of Curation in Aligning Large Language Models Against Safety Compromise
Speculative Safety-Aware Decoding
PanicToCalm: A Proactive Counseling Agent for Panic Attacks
CoPL: Collaborative Preference Learning for Personalizing LLMs
Dynamic Collaboration of Multi-Language Models based on Minimal Complete Semantic Units
AI Chatbots as Professional Service Agents: Developing a Professional Identity
DeepResonance: Enhancing Multimodal Music Understanding via Music-centric Multi-way Instruction Tuning
Advancing Oversight Reasoning across Languages for Audit Sycophantic Behaviour via X-Agent
CAFE: Retrieval Head-based Coarse-to-Fine Information Seeking to Enhance Multi-Document QA Capability
SSA-COMET: Do LLMs Outperform Learned Metrics in Evaluating MT for Under-Resourced African Languages?
FaithUn: Toward Faithful Forgetting in Language Models by Investigating the Interconnectedness of Knowledge
Calibrating Pseudo-Labeling with Class Distribution for Semi-supervised Text Classification
Coarse-to-Fine Grounded Memory for LLM Agent Planning
From A and B to A+B: Can Large Language Models Solve Compositional Math Problems?
Sycophancy Mitigation Through Reinforcement Learning with Uncertainty-Aware Adaptive Reasoning Trajectories
SimVBG: Simulating Individual Values by Backstory Generation
EvolveSearch: An Iterative Self-Evolving Search Agent
Syntax-Aware Retrieval Augmentation for Neural Symbolic Regression
Merge then Realign: Simple and Effective Modality-Incremental Continual Learning for Multimodal LLMs
Graceful Forgetting in Generative Language Models
Answering Narrative-Driven Recommendation Queries via a Retrieve–Rank Paradigm and the OCG-Agent
Direct Value Optimization: Improving Chain-of-Thought Reasoning in LLMs with Refined Values
Jailbreak-Tuning: Models Efficiently Learn Jailbreak Susceptibility
Neural Topic Modeling via Contextual and Graph Information Fusion
CARE: A Disagreement Detection Framework with Concept Alignment and Reasoning Enhancement
Beyond Task-Oriented and Chitchat Dialogues: Proactive and Transition-Aware Conversational Agents
LightThinker: Thinking Step-by-Step Compression
How Is LLM Reasoning Distracted by Irrelevant Context? An Analysis Using a Controlled Benchmark
Investigating Pedagogical Teacher and Student LLM Agents: Genetic Adaptation Meets Retrieval-Augmented Generation Across Learning Styles
GeoEdit: Geometric Knowledge Editing for Large Language Models
A Generative Pre-Trained Language Model for Channel Prediction in Wireless Communications Systems
AIMMerging: Adaptive Iterative Model Merging Using Training Trajectories for Language Model Continual Learning
R-PRM: Reasoning-Driven Process Reward Modeling
RLAE: Reinforcement Learning-Assisted Ensemble for LLMs
Do Large Language Models Truly Grasp Addition? A Rule-Focused Diagnostic Using Two-Integer Arithmetic
AskToAct: Enhancing LLMs Tool Use via Self-Correcting Clarification
START: Self-taught Reasoner with Tools
The Impact of Negated Text on Hallucination with Large Language Models
A Probabilistic Inference Scaling Theory for LLM Self-Correction
MentalGLM Series: Explainable Large Language Models for Mental Health Analysis on Chinese Social Media
Knowledge-Aware Co-Reasoning for Multidisciplinary Collaboration
Astra: Efficient Transformer Architecture and Contrastive Dynamics Learning for Embodied Instruction Following
MAVL: A Multilingual Audio-Video Lyrics Dataset for Animated Song Translation
MuTIS: Enhancing Reasoning Efficiency through Multi Turn Intervention Sampling in Reinforcement Learning
PRIM: Towards Practical In-Image Multilingual Machine Translation
Mind the Inclusivity Gap: Multilingual Gender-Neutral Translation Evaluation with mGeNTE
DiplomacyAgent: Do LLMs Balance Interests and Ethical Principles in International Events?
DisLoRA: Task-specific Low-Rank Adaptation via Orthogonal Basis from Singular Value Decomposition
Unmasking Deceptive Visuals: Benchmarking Multimodal Large Language Models on Misleading Chart Question Answering
Textual Aesthetics in Large Language Models
Section-Level Simplification of Biomedical Abstracts
PoseStitch-SLT: Linguistically Inspired Pose-Stitching for End-to-End Sign Language Translation
Few-Shot Open-Set Classification via Reasoning-Aware Decomposition
Translation in the Hands of Many: Centering Lay Users in Machine Translation Interactions
iTool: Reinforced Fine-Tuning with Dynamic Deficiency Calibration for Advanced Tool Use
Transplant Then Regenerate: A New Paradigm for Text Data Augmentation
Compositional Generalisation for Explainable Hate Speech Detection
CCQA: Generating Question from Solution Can Improve Inference-Time Reasoning in SLMs
TVQACML: Benchmarking Text-Centric Visual Question Answering in Multilingual Chinese Minority Languages
Transparent and Coherent Procedural Mistake Detection
Teaching Your Models to Understand Code via Focal Preference Alignment
MoLoRAG: Bootstrapping Document Understanding via Multi-modal Logic-aware Retrieval
Vision-Free Retrieval: Rethinking Multimodal Search with Textual Scene Descriptions
TableRAG: A Retrieval Augmented Generation Framework for Heterogeneous Document Reasoning
Retrieval Enhanced Feedback via In-context Neural Error-book
Improve LLM-as-a-Judge Ability as a General Ability
G2: Guided Generation for Enhanced Output Diversity in LLMs
ToolSafety: A Comprehensive Dataset for Enhancing Safety in LLM-Based Agent Tool Invocations
Learning to See through Sound: From VggCaps to Multi2Cap for Richer Automated Audio Captioning
Towards Optimal Evaluation Efficiency for Large Language Models
MMAPG: A Training-Free Framework for Multimodal Multi-hop Question Answering via Adaptive Planning Graphs
Mixture-of-Clustered-Experts: Advancing Expert Specialization and Generalization in Instruction Tuning
Process-Supervised Reinforcement Learning for Code Generation
MuCAL: Contrastive Alignment for Preference-Driven KG-to-Text Generation
Advancing Fine-Grained Visual Understanding with Multi-Scale Alignment in Multi-Modal Models
Thought calibration: Efficient and confident test-time scaling
Can LLMs Reason Abstractly Over Math Word Problems Without CoT? Disentangling Abstract Formulation From Arithmetic Computation
QCRD: Quality-guided Contrastive Rationale Distillation for Large Language Models
SHARP: Steering Hallucination in LVLMs via Representation Engineering
Think, Verbalize, then Speak: Bridging Complex Thoughts and Comprehensible Speech
Warm Up Before You Train: Unlocking General Reasoning in Resource-Constrained Settings
PPTAgent: Generating and Evaluating Presentations Beyond Text-to-Slides
SWAM: Adaptive Sliding Window and Memory-Augmented Attention Model for Rumor Detection
HydraRAG: Structured Cross-Source Enhanced Large Language Model Reasoning
VRoPE: Rotary Position Embedding for Video Large Language Models
SciNLP: A Domain-Specific Benchmark for Full-Text Scientific Entity and Relation Extraction in NLP
Think and Recall: Layer-Level Prompting for Lifelong Model Editing
SPIRIT: Patching Speech Language Models against Jailbreak Attacks
FIRE: Flexible Integration of Data Quality Ratings for Effective Pretraining
Multi-Domain Explainability of Preferences
Tuning Less, Prompting More: In-Context Preference Learning Pipeline for Natural Language Transformation
IL-PCSR: Legal Corpus for Prior Case and Statute Retrieval
ESGenius: Benchmarking LLMs on Environmental, Social, and Governance (ESG) and Sustainability Knowledge
How Sememic Components Can Benefit Link Prediction for Lexico-Semantic Knowledge Graphs?
WISE: Weak-Supervision-Guided Step-by-Step Explanations for Multimodal LLMs in Image Classification
Calibration Across Layers: Understanding Calibration Evolution in LLMs
The discordance between embedded ethics and cultural inference in large language models
SSA: Semantic Contamination of LLM-Driven Fake News Detection
Logits-Based Finetuning
STARE at the Structure: Steering ICL Exemplar Selection with Structural Alignment
PPC-GPT: Federated Task-Specific Compression of Large Language Models via Pruning and Chain-of-Thought Distillation
Efficient Beam Search for Large Language Models Using Trie-Based Decoding
Power doesn’t reside in size: A Low Parameter Hybrid Language Model (HLM) for Sentiment Analysis in Code-mixed data
Evaluating Taxonomy Free Character Role Labeling (TF-CRL) in News Stories using Large Language Models
MIRROR: Multimodal Cognitive Reframing Therapy for Rolling with Resistance
RETAIL: Towards Real-world Travel Planning for Large Language Models
Unraveling Interwoven Roles of Large Language Models in Authorship Privacy: Obfuscation, Mimicking, and Verification
Reward Model Perspectives: Whose Opinions Do Reward Models Reward?
FLRC: Fine-grained Low-Rank Compressor for Efficient LLM Inference
Do You Know About My Nation? Investigating Multilingual Language Models’ Cultural Literacy Through Factual Knowledge
CoEvo: Coevolution of LLM and Retrieval Model for Domain-Specific Information Retrieval
Conan-Embedding-v2: Training an LLM from Scratch for Text Embeddings
Vision-and-Language Navigation with Analogical Textual Descriptions in LLMs
MUCAR: Benchmarking Multilingual Cross-Modal Ambiguity Resolution for Multimodal Large Language Models
Mind the Gap: How BabyLMs Learn Filler-Gap Dependencies
Paths Not Taken: Understanding and Mending the Multilingual Factual Recall Pipeline
BTC-SAM: Leveraging LLMs for Generation of Bias Test Cases for Sentiment Analysis Models
Debate-to-Detect: Reformulating Misinformation Detection as a Real-World Debate with Large Language Models
Controllable Memorization in LLMs via Weight Pruning
Tracing L1 Interference in English Learner Writing: A Longitudinal Corpus with Error Annotations
DCIS: Efficient Length Extrapolation of LLMs via Divide-and-Conquer Scaling Factor Search
Who is in the Spotlight: The Hidden Bias Undermining Multimodal Retrieval-Augmented Generation
Let’s Play Across Cultures: A Large Multilingual, Multicultural Benchmark for Assessing Language Models’ Understanding of Sports
Multilingual Federated Low-Rank Adaptation for Collaborative Content Anomaly Detection across Multilingual Social Media Participants
M3Retrieve: Benchmarking Multimodal Retrieval for Medicine
The Hidden Strength of Disagreement: Unraveling the Consensus-Diversity Tradeoff in Adaptive Multi-Agent Systems
Friend or Foe? A Computational Investigation of Semantic False Friends across Romance Languages
KLAAD: Refining Attention Mechanisms to Reduce Societal Bias in Generative Language Models
SeMob: Semantic Synthesis for Dynamic Urban Mobility Prediction
DyePack: Provably Flagging Test Set Contamination in LLMs Using Backdoors
Minimal, Local, and Robust: Embedding-Only Edits for Implicit Bias in T2I Models
Journalism-Guided Agentic In-context Learning for News Stance Detection
Less Is MuRE: Revisiting Shallow Knowledge Graph Embeddings
Jailbreak LLMs through Internal Stance Manipulation
Pierce the Mists, Greet the Sky: Decipher Knowledge Overshadowing via Knowledge Circuit Analysis
Complex Numerical Reasoning with Numerical Semantic Pre-training Framework
Automated Knowledge Graph Construction using Large Language Models and Sentence Complexity Modelling
OntologyRAG-Q: Resource Development and Benchmarking for Retrieval-Augmented Question Answering in Qur’anic Tafsir
The Practical Impacts of Theoretical Constructs on Empathy Modeling
RecBase: Generative Foundation Model Pretraining for Zero-Shot Recommendation
Grouping Entities with Shared Properties using Multi-Facet Prompting and Property Embeddings
Context-Aware Hierarchical Taxonomy Generation for Scientific Papers via LLM-Guided Multi-Aspect Clustering
Benchmark Profiling: Mechanistic Diagnosis of LLM Benchmarks
TreeReview: A Dynamic Tree of Questions Framework for Deep and Efficient LLM-based Scientific Peer Review
Improving Chemical Understanding of LLMs via SMILES Parsing
Can Large Language Models Tackle Graph Partitioning?
To See a World in a Spark of Neuron: Disentangling Multi-Task Interference for Training-Free Model Merging
What You Read Isn’t What You Hear: Linguistic Sensitivity in Deepfake Speech Detection
Task-Aware Resolution Optimization for Visual Large Language Models
CheckEval: A reliable LLM-as-a-Judge framework for evaluating text generation using checklists
A Necessary Step toward Faithfulness: Measuring and Improving Consistency in Free-Text Explanations
Boosting Multi-modal Keyphrase Prediction with Dynamic Chain-of-Thought in Vision-Language Models
Chart2Code53: A Large-Scale Diverse and Complex Dataset for Enhancing Chart-to-Code Generation
The State of Multilingual LLM Safety Research: From Measuring The Language Gap To Mitigating It
AIP: Subverting Retrieval-Augmented Generation via Adversarial Instructional Prompt
From Capabilities to Performance: Evaluating Key Functional Properties of LLM Architectures in Penetration Testing
Editing Across Languages: A Survey of Multilingual Knowledge Editing
Your RAG is Unfair: Exposing Fairness Vulnerabilities in Retrieval-Augmented Generation via Backdoor Attacks
Drift-Adapter: A Practical Approach to Near Zero-Downtime Embedding Model Upgrades in Vector Databases
The Staircase of Ethics: Probing LLM Value Priorities through Multi-Step Induction to Complex Moral Dilemmas
SliceMoE: Routing Embedding Slices Instead of Tokens for Fine-Grained and Balanced Transformer Scaling
ReSo: A Reward-driven Self-organizing LLM-based Multi-Agent System for Reasoning Tasks
ConstraintLLM: A Neuro-Symbolic Framework for Industrial-Level Constraint Programming
VisEscape: A Benchmark for Evaluating Exploration-driven Decision-making in Virtual Escape Rooms
ESC-Judge: A Framework for Comparing Emotional Support Conversational Agents
Neuron-Level Differentiation of Memorization and Generalization in Large Language Models
Sparse Neurons Carry Strong Signals of Question Ambiguity in LLMs
Do Slides Help? Multi-modal Context for Automatic Transcription of Conference Talks
Promote, Suppress, Iterate: How Language Models Answer One-to-Many Factual Queries
Out of Sight, Not Out of Context? Egocentric Spatial Reasoning in VLMs Across Disjoint Frames
Enhancing Chain-of-Thought Reasoning via Neuron Activation Differential Analysis
PakBBQ: A Culturally Adapted Bias Benchmark for QA
MULTIGUARD: An Efficient Approach for AI Safety Moderation Across Languages and Modalities
Comparing human and LLM politeness strategies in free production
ASTRA: A Negotiation Agent with Adaptive and Strategic Reasoning via Tool-integrated Action for Dynamic Offer Optimization
CARMA: Enhanced Compositionality in LLMs via Advanced Regularisation and Mutual Information Alignment
MEPT: Mixture of Expert Prompt Tuning as a Manifold Mapper
KG-CQR: Leveraging Structured Relation Representations in Knowledge Graphs for Contextual Query Retrieval
SABER: Uncovering Vulnerabilities in Safety Alignment via Cross-Layer Residual Connection
When Truthful Representations Flip Under Deceptive Instructions?
Can LLMs simulate the same correct solutions to free-response math problems as real students?
Evaluating Behavioral Alignment in Conflict Dialogue: A Multi-Dimensional Comparison of LLM Agents and Humans
RECALL: REpresentation-aligned Catastrophic-forgetting ALLeviation via Hierarchical Model Merging
Not-Just-Scaling Laws: Towards a Better Understanding of the Downstream Impact of Language Model Design Decisions
Synthetic Socratic Debates: Examining Persona Effects on Moral Decision and Persuasion Dynamics
Linear-Time Demonstration Selection for In-Context Learning via Gradient Estimation
Speech Vecalign: an Embedding-based Method for Aligning Parallel Speech Documents
TurBLiMP: A Turkish Benchmark of Linguistic Minimal Pairs
DynamicNER: A Dynamic, Multilingual, and Fine-Grained Dataset for LLM-based Named Entity Recognition
Reliable and Cost-Effective Exploratory Data Analysis via Graph-Guided RAG
Med-PRM: Medical Reasoning Models with Stepwise, Guideline-verified Process Rewards
Graders Should Cheat: Privileged Information Enables Expert-Level Automated Evaluations
SAMULE: Self-Learning Agents Enhanced by Multi-level Reflection
Database-Augmented Query Representation for Information Retrieval
The Enemy from Within: A Study of Political Delegitimization Discourse in Israeli Political Speech
Attention Eclipse: Manipulating Attention to Bypass LLM Safety-Alignment
Representation Potentials of Foundation Models for Multimodal Alignment: A Survey
Draft Model Knows When to Stop: Self-Verification Speculative Decoding for Long-Form Generation
Visual-Aware Speech Recognition for Noisy Scenarios
Advancing Arabic Diacritization: Improved Datasets, Benchmarking, and State-of-the-Art Models
Implicit Values Embedded in How Humans and LLMs Complete Subjective Everyday Tasks
Dynamic Retriever for In-Context Knowledge Editing via Policy Optimization
LVLMs are Bad at Overhearing Human Referential Communication
Let’s Reason Formally: Natural-Formal Hybrid Reasoning Enhances LLM’s Math Capability
TORSO: Template-Oriented Reasoning Towards General Tasks
Prototypical Human-AI Collaboration Behaviors from LLM-Assisted Writing in the Wild
WildScore: Benchmarking MLLMs in-the-Wild Symbolic Music Reasoning
TRIAL: Token Relations and Importance Aware Late-interaction for Accurate Text Retrieval
Do Large Language Models excel in Complex Logical Reasoning with Formal Language?
Fair or Framed? Political Bias in News Articles Generated by LLMs
ReviewRL: Towards Automated Scientific Review with RL
Grammar Pruning: Enabling Low-Latency Zero-Shot Task-Oriented Language Models for Edge AI
Calibrating LLMs for Text-to-SQL Parsing by Leveraging Sub-clause Frequencies
REACT: Representation Extraction And Controllable Tuning to Overcome Overfitting in LLM Knowledge Editing
ThinkEdit: Interpretable Weight Editing to Mitigate Overly Short Thinking in Reasoning Models
Incorporating Diverse Perspectives in Cultural Alignment: Survey of Evaluation Benchmarks Through A Three-Dimensional Framework
Are Large Language Models Chronically Online Surfers? A Dataset for Chinese Internet Meme Explanation
RoDEval: A Robust Word Sense Disambiguation Evaluation Framework for Large Language Models
PychoAgent: Psychology-driven LLM Agents for Explainable Panic Prediction on Social  Media during Sudden Disaster Events
Stepwise Reasoning Checkpoint Analysis: A Test Time Scaling Method to Enhance LLMs’ Reasoning
Inter-sentence Context Modeling and Structure-aware Representation Enhancement for Conversational Sentiment Quadruple Extraction
Igniting Creative Writing in Small Language Models: LLM-as-a-Judge versus Multi-Agent Refined Rewards
Governance in Motion: Co-evolution of Constitutions and AI models for Scalable Safety
Web Intellectual Property at Risk: Preventing Unauthorized Real-Time Retrieval by Large Language Models
SciEvent: Benchmarking Multi-domain Scientific Event Extraction
Media Source Matters More Than Content: Unveiling Political Bias in LLM-Generated Citations
RJE: A Retrieval-Judgment-Exploration Framework for Efficient Knowledge Graph Question Answering with LLMs
Bias Mitigation or Cultural Commonsense? Evaluating LLMs with a Japanese Dataset
Chameleon LLMs: User Personas Influence Chatbot Personality Shifts
GuessingGame: Measuring the Informativeness of Open-Ended Questions in Large Language Models
SynC-LLM: Generation of Large-Scale Synthetic Circuit Code with Hierarchical Language Models
Why Stop at One Error? Benchmarking LLMs as Data Science Code Debuggers for Multi-Hop and Multi-Bug Errors
Dovetail: A CPU/GPU Heterogeneous Speculative Decoding for LLM inference
V-SEAM: Visual Semantic Editing and Attention Modulating for Causal Interpretability of Vision-Language Models
LORAXBENCH: A Multitask, Multilingual Benchmark Suite for 20 Indonesian Languages
SAFE: Schema-Driven Approximate Distance Join for Efficient Knowledge Graph Querying
Structured Preference Optimization for Vision-Language Long-Horizon Task Planning
Position: LLMs Can be Good Tutors in English Education
CLLMate: A Multimodal Benchmark for Weather and Climate Events Forecasting
Extracting and Combining Abilities For Building Multi-lingual Ability-enhanced Large Language Models
Evaluating the Effectiveness and Scalability of LLM-Based Data Augmentation for Retrieval
Temporal Referential Consistency: Do LLMs Favor Sequences Over Absolute Time References?
MemeArena: Automating Context-Aware Unbiased Evaluation of Harmfulness Understanding for Multimodal Large Language Models
Multi-perspective Analysis of Large Language Model Domain Specialization: An Experiment in Accounting Audit Procedures Generation
Generator-Assistant Stepwise Rollback Framework for Large Language Model Agent
DocAgent: An Agentic Framework for Multi-Modal Long-Context Document Understanding
EasyRec: Simple yet Effective Language Models for Recommendation
From Automation to Autonomy: A Survey on Large Language Models in Scientific Discovery
Mapping the Minds of LLMs: A Graph-Based Analysis of Reasoning LLMs
ViPE: Visual Perception in Parameter Space for Efficient Video-Language Understanding
Alignment for Efficient Tool Calling of Large Language Models
ToM: Leveraging Tree-oriented MapReduce for Long-Context Reasoning in Large Language Models
BANMIME : Misogyny Detection with Metaphor Explanation on Bangla Memes
Phi: Preference Hijacking in Multi-modal Large Language Models at Inference Time
Retrieval-augmented GUI Agents with Generative Guidelines
COAS2W: A Chinese Older-Adults Spoken-to-Written Transformation Corpus with Context Awareness
Answer Convergence as a Signal for Early Stopping in Reasoning
VeriFact: Enhancing Long-Form Factuality Evaluation with Refined Fact Extraction and Reference Facts
SQUAB: Evaluating LLM robustness to Ambiguous and Unanswerable Questions in Semantic Parsing
Reliable Evaluation and Benchmarks for Statement Autoformalization
VisBias: Measuring Explicit and Implicit Social Biases in Vision Language Models
Less Is More? Examining Fairness in Pruned Large Language Models for Summarising Opinions
AI Sees Your Location—But With A Bias Toward The Wealthy World
Faster In-Context Learning for LLMs via N-Gram Trie Speculative Decoding
From Surveys to Narratives: Rethinking Cultural Value Adaptation in LLMs
Iterative Prompt Refinement for Safer Text-to-Image Generation
Language Models as Continuous Self-Evolving Data Engineers
Unilaw-R1: A Large Language Model for Legal Reasoning with Reinforcement Learning and Iterative Inference
Exploring Response Uncertainty in MLLMs: An Empirical Evaluation under Misleading Scenarios
Evaluating and Aligning Human Economic Risk Preferences in LLMs
Ensembling Prompting Strategies for Zero-Shot Hierarchical Text Classification with Large Language Models
Improbable Bigrams Expose Vulnerabilities of Incomplete Tokens in Byte-Level Tokenizers
UI-Hawk: Unleashing the Screen Stream Understanding for Mobile GUI Agents
UniDebugger: Hierarchical Multi-Agent Framework for Unified Software Debugging
Understanding the Thinking Process of Reasoning Models: A Perspective from Schoenfeld’s Episode Theory
Thread: A Logic-Based Data Organization Paradigm for How-To Question Answering with Retrieval Augmented Generation
Unsupervised Word-level Quality Estimation for Machine Translation Through the Lens of Annotators (Dis)agreement
STEER-BENCH: A Benchmark for Evaluating the Steerability of Large Language Models
Combining Constrained and Unconstrained Decoding via Boosting: BoostCD and Its Application to Information Extraction
MultiLogicNMR(er): A Benchmark and Neural-Symbolic Framework for Non-monotonic Reasoning with Multiple Extensions
Beyond Demographics: Enhancing Cultural Value Survey Simulation with Multi-Stage Personality-Driven Cognitive Reasoning
CrystalICL: Enabling In-Context Learning for Crystal Generation
Towards a Unified Paradigm of Concept Editing in Large Language Models
Step-level Verifier-guided Hybrid Test-Time Scaling for Large Language Models
Dynamic Expert Specialization: Towards Catastrophic Forgetting-Free Multi-Domain MoE Adaptation
RRInf: Efficient Influence Function Estimation via Ridge Regression for Large Language Models and Text-to-Image Diffusion Models
Evaluating Spatiotemporal Consistency in Automatically Generated Sewing Instructions
MaZO: Masked Zeroth-Order Optimization for Multi-Task Fine-Tuning of Large Language Models
Procedural Environment Generation for Tool-Use Agents
FacLens: Transferable Probe for Foreseeing Non-Factuality in Fact-Seeking Question Answering of Large Language Models
OMS: On-the-fly, Multi-Objective, Self-Reflective Ad Keyword Generation via LLM Agent
Med-VRAgent: A Framework for Medical Visual Reasoning-Enhanced Agents
TrojanWave: Exploiting Prompt Learning for Stealthy Backdoor Attacks on Large Audio-Language Models
Can LLMs be Literary Companions?: Analysing LLMs on Bengali Figures of Speech Identification
Group-SAE: Efficient Training of Sparse Autoencoders for Large Language Models via Layer Groups
Retrieval over Classification: Integrating Relation Semantics for Multimodal Relation Extraction
PunMemeCN: A Benchmark to Explore Vision-Language Models’ Understanding of Chinese Pun Memes
UltraIF: Advancing Instruction Following from the Wild
Identifying Pre-training Data in LLMs: A Neuron Activation-Based Detection Framework
TreeRare: Syntax Tree-Guided Retrieval and Reasoning for Knowledge-Intensive Question Answering
Mapping Toxic Comments Across Demographics: A Dataset from German Public Broadcasting
Small Models, Big Results: Achieving Superior Intent Extraction through Decomposition
On Pruning State-Space LLMs
An Orthogonal High-Rank Adaptation for Large Language Models
BSFA: Leveraging the Subspace Dichotomy to Accelerate Neural Network Training
Debatable Intelligence: Benchmarking LLM Judges via Debate Speech Evaluation
METok: Multi-Stage Event-based Token Compression for Efficient Long Video Understanding
VisiPruner: Decoding Discontinuous Cross-Modal Dynamics for Efficient Multimodal LLMs
Beyond Static Testbeds: An Interaction-Centric Agent Simulation Platform for Dynamic Recommender Systems
SheetDesigner: MLLM-Powered Spreadsheet Layout Generation with Rule-Based and Vision-Based Reflection
CAIR: Counterfactual-based Agent Influence Ranker for Agentic AI Workflows
ReSURE: Regularizing Supervision Unreliability for Multi-turn Dialogue Fine-tuning
Precise In-Parameter Concept Erasure in Large Language Models
PhonoThink: Improving Large Language Models’ Reasoning on Chinese Phonological Ambiguities
SAFE-SQL: Self-Augmented In-Context Learning with Fine-grained Example Selection for Text-to-SQL
ExpandR: Teaching Dense Retrievers Beyond Queries with LLM Guidance
Anecdoctoring: Automated Red-Teaming Across Language and Place
ACING: Actor-Critic for Instruction Learning in Black-Box LLMs
Women, Infamous, and Exotic Beings: A Comparative Study of Honorific Usages in Wikipedia and LLMs for Bengali and Hindi
Process-Supervised Reward Models for Verifying Clinical Note Generation: A Scalable Approach Guided by Domain Expertise
GCML: Gradient Coherence Guided Meta-Learning for Cross-Domain Emerging Topic Rumor Detection
Can LLMs Generate and Solve Linguistic Olympiad Puzzles?
E2LLM: Encoder Elongated Large Language Models for Long-Context Understanding and Reasoning
DivScore: Zero-Shot Detection of LLM-Generated Text in Specialized Domains
Multi-Document Event Extraction Using Large and Small Language Models
MA-GTS: A Multi-Agent Framework for Solving Complex Graph Problems in Real-World Applications
Enhancing Speech Large Language Models with Prompt-Aware Mixture of Audio Encoders
CIKT: A Collaborative and Iterative Knowledge Tracing Framework with Large Language Models
Mitigating Hallucinations in LM-Based TTS Models via Distribution Alignment Using GFlowNets
MolErr2Fix: Benchmarking LLM Trustworthiness in Chemistry via Modular Error Detection, Localization, Explanation, and Correction
Shared Path: Unraveling Memorization in Multilingual LLMs through Language Similarities
Embedding Domain Knowledge for Large Language Models via Reinforcement Learning from Augmented Generation
LLM-Driven Completeness and Consistency Evaluation for Cultural Heritage Data Augmentation in Cross-Modal Retrieval
Artificial Impressions: Evaluating Large Language Model Behavior Through the Lens of Trait Impressions
Mitigating Hallucinations in Large Vision-Language Models via Entity-Centric Multimodal Preference Optimization
3DS: Medical Domain Adaptation of LLMs via Decomposed Difficulty-based Data Selection
InfiniBench: A Benchmark for Large Multi-Modal Models in Long-Form Movies and TV Shows
Intrinsic Test of Unlearning Using Parametric Knowledge Traces
Speculative Streaming: Efficient and Scalable Speculative Decoding with Multi-Stream Attention
Evaluating Cognitive-Behavioral Fixation via Multimodal User Viewing Patterns on Social Media
Mind the Gap: A Closer Look at Tokenization for Multiple-Choice Question Answering with LLMs
VocalNet: Speech LLMs with Multi-Token Prediction for Faster and High-Quality Generation
Path Drift in Large Reasoning Models: How First-Person Commitments Override Safety
CBP-Tuning: Efficient Local Customization for Black-box Large Language Models
Beyond the Score: Uncertainty-Calibrated LLMs for Automated Essay Assessment
Humans Hallucinate Too: Language Models Identify and Correct Subjective Annotation Errors With Label-in-a-Haystack Prompts
$\textit{Do It Yourself (DIY)}$: Modifying Images for Poems in a Zero-Shot Setting Using Weighted Prompt Manipulation
Looking Beyond Text: Reducing Language Bias in Large Vision-Language Models via Multimodal Dual-Attention and Soft-Image Guidance
Who Holds the Pen? Caricature and Perspective in LLM Retellings of History
DSMoE: Matrix-Partitioned Experts with Dynamic Routing for Computation-Efficient Dense LLMs
Search Wisely: Mitigating Sub-optimal Agentic Searches By Reducing Uncertainty
Child-Directed Language Does Not Consistently Boost Syntax Learning in Language Models
Benchmarking Debiasing Methods for LLM-based Parameter Estimates
(Almost) Free Modality Stitching of Foundation Models
VERITAS: Leveraging Vision Priors and Expert Fusion to Improve Multimodal Data
Rescorla-Wagner Steering of LLMs for Undesired Behaviors over Disproportionate Inappropriate Context
Exploring Artificial Image Generation for Stance Detection
Hope vs. Hate: Understanding User Interactions with LGBTQ+ News Content in Mainstream US News Media through the Lens of Hope Speech
Flaw or Artifact? Rethinking Prompt Sensitivity in Evaluating LLMs
Topic Coverage-based Demonstration Retrieval for In-Context Learning
On the Same Wavelength? Evaluating Pragmatic Reasoning in Language Models across Broad Concepts
MuseScorer: Idea Originality Scoring At Scale
SAFENUDGE: Safeguarding Large Language Models in Real-time with Tunable Safety-Performance Trade-offs
RaDeR: Reasoning-aware Dense Retrieval Models
A Culturally-diverse Multilingual Multimodal Video Benchmark & Model
DRES: Fake news detection by dynamic representation and ensemble selection
A Graph-Theoretical Framework for Analyzing the Behavior of Causal Language Models
Membership and Memorization in LLM Knowledge Distillation
Balanced Multi-Factor In-Context Learning for Multilingual Large Language Models
Efficient Context Selection for Long-Context QA: No Tuning, No Iteration, Just Adaptive‑$k$
Languages Still Left Behind: Toward a Better Multilingual Machine Translation Benchmark
Think Globally, Group Locally: Evaluating LLMs Using Multi-Lingual Word Grouping Games
Pointing to a Llama and Call it a Camel: On the Sycophancy of Multimodal Large Language Models
MR. Judge: Multimodal Reasoner as a Judge
MobiZO: Enabling Efficient LLM Fine-Tuning at the Edge via Inference Engines
Fann or Flop: A Multigenre, Multiera Benchmark for Arabic Poetry Understanding in LLMs
CoMAT: Chain of Mathematically Annotated Thought Improves Mathematical Reasoning
s1: Simple test-time scaling
Learning Subjective Label Distributions via Sociocultural Descriptors
COM-BOM: Bayesian Exemplar Search for Efficiently Exploring the Accuracy-Calibration Pareto Frontier
ML-Promise: A Multilingual Dataset for Corporate Promise Verification
Reading Between the Prompts: How Stereotypes Shape LLM’s Implicit Personalization
Paired by the Teacher: Turning Unpaired Data into High-Fidelity Pairs for Low-Resource Text Generation
Please Translate Again: Two Simple Experiments on Whether Human-Like Reasoning Helps Translation
How Do Large Vision-Language Models See Text in Image? Unveiling the Distinctive Role of OCR Heads
Explainability and Interpretability of Multilingual Large Language Models: A Survey
Decoding the Rule Book: Extracting Hidden Moderation Criteria from Reddit Communities
AcT2I: Evaluating and Improving Action Depiction in Text-to-Image Models
Assessing French Readability for Adults with Low Literacy: A Global and Local Perspective
LILaC: Late Interacting in Layered Component Graph for Open-domain Multimodal Multihop Retrieval
DiCoRe: Enhancing Zero-shot Event Detection via Divergent-Convergent LLM Reasoning
SNaRe: Domain-aware Data Generation for Low-Resource Event Detection
Table-R1: Inference-Time Scaling for Table Reasoning Tasks
LimRank: Less is More for Reasoning-Intensive Information Reranking
PlanGEN: A Multi-Agent Framework for Generating Planning and Reasoning Trajectories for Complex Problem Solving
An Empirical Study on Strong-Weak Model Collaboration for Repo-level Code Generation
What are Foundation Models Cooking in the Post-Soviet World?
LogiDynamics: Unraveling the Dynamics of Inductive, Abductive and Deductive Logical Inferences in LLM Reasoning
EcoLoRA: Communication-Efficient Federated Fine-Tuning of Large Language Models
Memorization $\neq$ Understanding: Do Large Language Models Have the Ability of Scenario Cognition?
Priority on High-Quality: Selecting Instruction Data via Consistency Verification of Noise Injection
Can Prompts Rewind Time for LLMs? Evaluating the Effectiveness of Prompted Knowledge Cutoffs
DSVD: Dynamic Self-Verify Decoding for Faithful Generation in Large Language Models
Metric Calculating Benchmark: Code-Verifiable Complicate Instruction Following Benchmark for Large Language Models
Generative Annotation for ASR Named Entity Correction
SOLAR: Towards Characterizing Subjectivity of Individuals through Modeling Value Conflicts and Trade-offs
LogicTree: Structured Proof Exploration for Coherent and Rigorous Logical Reasoning with Large Language Models
Unmasking Fake Careers: Detecting Machine-Generated Career Trajectories via Multi-layer Heterogeneous Graphs
GAP: a Global Adaptive Pruning Method for Large Language Models
Distribution Prompting: Understanding the Expressivity of Language Models Through the Next-Token Distributions They Can Produce
LGA: LLM-GNN Aggregation for Temporal Evolution Attribute Graph Prediction
EIFBENCH: Extremely Complex Instruction Following Benchmark for Large Language Models
Tool Preferences in Agentic LLMs are Unreliable
Enhancing Large Language Model for Knowledge Graph Completion via Structure-Aware Alignment-Tuning
MultiDocFusion : Hierarchical and Multimodal Chunking Pipeline for Enhanced RAG on Long Industrial Documents
Attention-guided Self-reflection for Zero-shot Hallucination Detection in Large Language Models
‘Rich Dad, Poor Lad’: How do Large Language Models Contextualize Socioeconomic Factors in College Admission ?
Understanding and Mitigating Overrefusal in LLMs from an Unveiling Perspective of Safety Decision Boundary
MMAG: Multimodal Learning for Mucus Anomaly Grading in Nasal Endoscopy via Semantic Attribute Prompting
The Emperor’s New Reasoning: Format Imitation Overshadows Genuine Mathematical Understanding in SFT
Step Guided Reasoning: Improving Mathematical Reasoning using Guidance Generation and Step Reasoning
Flexibly Utilize Memory for Long-Term Conversation via a Fragment-then-Compose Framework
STRICT: Stress-Test of Rendering Image Containing Text
A Sequential Multi-Stage Approach for Code Vulnerability Detection via Confidence- and Collaboration-based Decision Making
Leveraging Large Models to Evaluate Novel Content: A Case Study on Advertisement Creativity
BIRD: Bronze Inscription Restoration and Dating
DCP: Dual-Cue Pruning for Efficient Large Vision-Language Models
Improving Context Fidelity via Native Retrieval-Augmented Reasoning
Koel-TTS: Enhancing LLM based Speech Generation with Preference Alignment and Classifier Free Guidance
Mixing Inference-time Experts for Enhancing LLM Reasoning
Reinforced Query Reasoners for Reasoning-intensive Retrieval Tasks
TokenSelect: Efficient Long-Context Inference and Length Extrapolation for LLMs via Dynamic Token-Level KV Cache Selection
MUSE: MCTS-Driven Red Teaming Framework for Enhanced Multi-Turn Dialogue Safety in Large Language Models
EnAnchored-X2X: English-Anchored Optimization for Many-to-Many Translation
“I’ve Decided to Leak”: Probing Internals Behind Prompt Leakage Intents
Nullspace Disentanglement for Red Teaming Language Models
Supervised Attention Mechanism for Low-quality Multimodal Data
Reinforcement Learning for Large Language Models via Group Preference Reward Shaping
zFLoRA: Zero-Latency Fused Low-Rank Adapters
PLAN-TUNING: Post-Training Language Models to Learn Step-by-Step Planning for Complex Problem Solving
Semantic Inversion, Identical Replies: Revisiting Negation Blindness in Large Language Models
AMACE: Automatic Multi-Agent Chart Evolution for Iteratively Tailored Chart Generation
ActionStudio: A Lightweight Framework for Data and Training of Large Action Models
Interpretation Meets Safety: A Survey on Interpretation Methods and Tools for Improving LLM Safety
Unveiling the Response of Large Vision-Language Models to Visually Absent Tokens
Improving Task Diversity in Label Efficient Supervised Finetuning of LLMs
Look Beyond Feeling: Unveiling Latent Needs from Implicit Expressions for Proactive Emotional Support
s3: You Don’t Need That Much Data to Train a Search Agent via RL
FuseChat: Knowledge Fusion of Chat Models
Continuous-Time Attention: PDE-Guided Mechanisms for Long-Sequence Transformers
Forget What You Know about LLMs Evaluations - LLMs are Like a Chameleon
Memorization or Reasoning? Exploring the Idiom Understanding of LLMs
RD-MCSA: A Multi-Class Sentiment Analysis Approach Integrating In-Context Classification Rationales and Demonstrations
Puzzled by Puzzles: When Vision-Language Models Can’t Take a Hint
CREPE: Rapid Chest X-ray Report Evaluation by Predicting Multi-category Error Counts
TIDES: Technical Information Discovery and Extraction System
Learning to Ask: When LLM Agents Meet Unclear Instruction
RICO: Improving Accuracy and Completeness in Image Recaptioning via Visual Reconstruction
StepSearch: Igniting LLMs Search Ability via Step-Wise Proximal Policy Optimization
Dynamic Model-Bank Test-Time Adaptation for Automatic Speech Recognition
Mitigating Catastrophic Forgetting in Large Language Models with Forgetting-aware Pruning
Does Localization Inform Unlearning? A Rigorous Examination of Local Parameter Attribution for Knowledge Unlearning in Language Models
ArgCMV: An Argument Summarization Benchmark for the LLM-era
VistaWise: Building Cost-Effective Agent with Cross-Modal Knowledge Graph for Minecraft
GraphKV: Breaking the Static Selection Paradigm with Graph-Based KV Cache Eviction
Joint Modeling of Entities and Discourse Relations for Coherence Assessment
Understanding and Leveraging the Expert Specialization of Context Faithfulness in Mixture-of-Experts LLMs
HMoE: Heterogeneous Mixture of Experts for Language Modeling
The Ranking Blind Spot: Decision Hijacking in LLM-based Text Ranking
Uniform Information Density and Syntactic Reduction: Revisiting that-Mentioning in English Complement Clauses
GRIT: Guided Relational Integration for Efficient Multi-Table Understanding
RPDR: A Round-trip Prediction-Based Data Augmentation Framework for Long-Tail Question Answering
Discrepancy Detection at the Data Level: Toward Consistent Multilingual Question Answering
Data-Efficient Selection via Grammatical Complexity in Continual Pre-training of Domain-Specific LLMs
Comprehensive and Efficient Distillation for Lightweight Sentiment Analysis Models
One Planner To Guide Them All ! Learning Adaptive Conversational Planners for Goal-oriented Dialogues
Unsupervised Hallucination Detection by Inspecting Reasoning Processes
Multimodal Neural Machine Translation: A Survey of the State of the Art
Lemmatization of Polish Multi-word Expressions
Targeted Distillation for Sentiment Analysis
DiffusionAttacker: Diffusion-Driven Prompt Manipulation for LLM Jailbreak
Rank-Awareness and Angular Constraints: A New Perspective on Learning Sentence Embeddings from NLI Data
LLM-Guided Semantic Relational Reasoning for Multimodal Intent Recognition
Seeing Culture: A Benchmark for Visual Reasoning and Grounding
GRADA: Graph-based Reranking against Adversarial Documents Attack
Orchestrating Audio: Multi-Agent Framework for Long-Video Audio Synthesis
MADAWSD: Multi-Agent Debate Framework for Adversarial Word Sense Disambiguation
Interpretable Text Embeddings and Text Similarity Explanation: A Survey
Dyve: Thinking Fast and Slow for Dynamic Process Verification
PERSEVAL: A Framework for Perspectivist Classification Evaluation
Massive Supervised Fine-tuning Experiments Reveal How Data, Layer, and Training Factors Shape LLM Alignment Quality
IndiGEC: Multilingual Grammar Error Correction for Low-Resource Indian Languages
Bias Beware: The Impact of Cognitive Biases on LLM-Driven Product Recommendations
T2R-BENCH: A Benchmark for Real World Table-to-Report Task
TCP: a Benchmark for Temporal Constraint-Based Planning
The Role of Outgoing Connection Heterogeneity in Feedforward Layers of Large Language Models
Follow the Flow: Fine-grained Flowchart Attribution with Neurosymbolic Agents
Collaborative Rational Speech Act: Pragmatic Reasoning for Multi-Turn Dialog
Understanding Subword Compositionality of Large Language Models
Internal Chain-of-Thought: Empirical Evidence for Layer‑wise Subtask Scheduling in LLMs
From Understanding to Generation: An Efficient Shortcut for Evaluating Language Models
Debiasing Multilingual LLMs in Cross-lingual Latent Space
Context is Gold to find the Gold Passage: Evaluating and Training Contextual Document Embeddings
MS-RAG: Simple and Effective Multi-Semantic Retrieval-Augmented Generation
Transitive self-consistency evaluation of NLI models without gold labels
MiLQ: Benchmarking IR Models for Bilingual Web Search with Mixed Language Queries
Enhancing Chinese Offensive Language Detection with Homophonic Perturbation
Persona-Augmented Benchmarking: Evaluating LLMs Across Diverse Writing Styles
Computational Analysis of Character Development in Holocaust Testimonies
TASO: Task-Aligned Sparse Optimization for Parameter-Efficient Model Adaptation
Dual-Path Counterfactual Integration for Multimodal Aspect-Based Sentiment Classification
Job Unfair: An Investigation of Gender and Occupational Bias in Free-Form Text Completions by LLMs
C3: A Bilingual Benchmark for Spoken Dialogue Models Exploring Challenges in Complex Conversations
Understanding LLMs’ Cross-Lingual Context Retrieval: How Good It Is And Where It Comes From
Blind Men and the Elephant: Diverse Perspectives on Gender Stereotypes in Benchmark Datasets
Linguistic and Embedding-Based Profiling of Texts Generated by Humans and Large Language Models
An Interdisciplinary Approach to Human-Centered Machine Translation
Exploring the Hidden Capacity of LLMs for One-Step Text Generation
Mixture of Weight-shared Heterogeneous Group Attention Experts for Dynamic Token-wise KV Optimization
PathwiseRAG: Multi-Dimensional Exploration and Integration Framework
“Mm, Wat?” Detecting Other-intiated Repair Requests in Dialogue
R-BPE: Improving BPE-Tokenizers with Token Reuse
Language Models Can be Efficiently Steered via Minimal Embedding Layer Transformations
Adversarial Attacks Against Automated Fact-Checking: A Survey
WildDoc: How Far Are We from Achieving Comprehensive and Robust Document Understanding in the Wild?
DCR: Quantifying Data Contamination in LLMs Evaluation
Building Trust in Clinical LLMs: Bias Analysis and Dataset Transparency
Surprise Calibration for Better In-Context Learning
SPARK: Simulating the Co-evolution of Stance and Topic Dynamics in Online Discourse with LLM-based Agents
Drivel-ology: Challenging LLMs with Interpreting Nonsense with Depth
Can Large Language Models be Effective Online Opinion Miners?
Can Large Language Models Translate Unseen Languages in Underrepresented Scripts?
KCS: Diversify Multi-hop Question Generation with Knowledge Composition Sampling
Fooling the LVLM Judges: Visual Biases in LVLM-Based Evaluation
Disentangled Information Bottleneck for Adversarial Text Defense
How do Language Models Reshape Entity Alignment? A Survey of LM-Driven EA Methods: Advances, Benchmarks, and Future
Enhancing LLM-Based Social Bot via an Adversarial Learning Framework
GER-LLM: Efficient and Effective Geospatial Entity Resolution with Large Language Model
CodeRAG: Finding Relevant and Necessary Knowledge for Retrieval-Augmented Repository-Level Code Completion
Searching for the Most Human-like Emergent Language
Does Context Matter? A Prosodic Comparison of English and Spanish in Monolingual and Multilingual Discourse Settings
ZERA: Zero-init Instruction Evolving Refinement Agent – From Zero Instructions to Structured Prompts via Principle-based Optimization
Toward Machine Interpreting: Lessons from Human Interpreting Studies
FlashAdventure: A Benchmark for GUI Agents Solving Full Story Arcs in Diverse Adventure Games
FLARE: Faithful Logic-Aided Reasoning and Exploration
Discourse-Driven Code-Switching: Analyzing the Role of Content and Communicative Function in Spanish-English Bilingual Speech
Can Large Language Models Translate Spoken-Only Languages through International Phonetic Transcription?
ClimateViz: A Benchmark for Statistical Reasoning and Fact Verification on Scientific Charts
Bridging the Gap Between Molecule and Textual Descriptions via Substructure-aware Alignment
SLlama: Parameter-Efficient Language Model Architecture for Enhanced Linguistic Competence Under Strict Data Constraints
What You See is What You Ask: Evaluating Audio Descriptions
TAPS: Tool-Augmented Personalisation via Structured Tagging
Investigating How Pre-training Data Leakage Affects Models’ Reproduction and Detection Capabilities
Walk and Read Less: Improving the Efficiency of Vision-and-Language Navigation via Tuning-Free Multimodal Token Pruning
Connecting the Knowledge Dots: Retrieval-augmented Knowledge Connection for Commonsense Reasoning
Agent-as-Judge for Factual Summarization of Long Narratives
DnDScore: Decontextualization and Decomposition for Factuality Verification in Long-Form Text Generation
RAcQUEt: Unveiling the Dangers of Overlooked Referential Ambiguity in Visual LLMs
Resource-Rational Noisy-Channel Language Processing: Testing the Effect of Algorithmic Constraints on Inferences
In Benchmarks We Trust … Or Not?
Video2Roleplay: A Multimodal Dataset and Framework for Video-Guided Role-playing Agents
Discriminating Form and Meaning in Multilingual Models with Minimal-Pair ABX Tasks
Rethinking Text-based Protein Understanding: Retrieval or LLM?
Grounded Semantic Role Labelling from Synthetic Multimodal Data for Situated Robot Commands
Easy as PIE? Identifying Multi-Word Expressions with LLMs
Query-Focused Retrieval Heads Improve Long-Context Reasoning and Re-ranking
Robust Adaptation of Large Multimodal Models for Retrieval Augmented Hateful Meme Detection
Audio-Reasoner: Improving Reasoning Capability in Large Audio Language Models
From perception to production: how acoustic invariance facilitates articulatory learning in a self-supervised vocal imitation model
REALM: Recursive Relevance Modeling for LLM-based Document Re-Ranking
PLLuM-Align: Polish Preference Dataset for Large Language Model Alignment
Graph-R1: Incentivizing the Zero-Shot Graph Learning Capability in LLMs via Explicit Reasoning
Scalable and Culturally Specific Stereotype Dataset Construction via Human-LLM Collaboration
Can Large Language Models Be Good Language Teachers?
Empowering Math Problem Generation and Reasoning for Large Language Model via Synthetic Data based Continual Learning Framework
Tokenization and Representation Biases in Multilingual Models on Dialectal NLP Tasks
Evaluating the Evaluators: Are readability metrics good measures of readability?
Text Takes Over: A Study of Modality Bias in Multimodal Intent Detection
What’s in a prompt? Language models encode literary style in prompt embeddings
Identifying and Answering Questions with False Assumptions: An Interpretable Approach
VisFinEval: A Scenario-Driven Chinese Multimodal Benchmark for Holistic Financial Understanding
Socratic-MCTS: Test-Time Visual Reasoning by Asking the Right Questions
LLMs Don’t Know Their Own Decision Boundaries:  The Unreliability of Self-Generated Counterfactual Explanations
Grounding Multilingual Multimodal LLMs With Cultural Knowledge
Following Length Constraints in Instructions
Memory-QA: Answering Recall Questions Based on Multimodal Memories
NEXUS: Network Exploration for eXploiting Unsafe Sequences in Multi-Turn LLM Jailbreaks
Sketch-of-Thought: Efficient LLM Reasoning with Adaptive Cognitive-Inspired Sketching
From Language to Cognition: How LLMs Outgrow the Human Language Network
Logos as a Well-Tempered Pre-train for Sign Language Recognition
Hallucination Detection in LLMs Using Spectral Features of Attention Maps
Composable Cross-prompt Essay Scoring by Merging Models
Towards a Holistic and Automated Evaluation Framework for Multi-Level Comprehension of LLMs in Book-Length Contexts
Improving Large Language Models Function Calling and Interpretability via Guided-Structured Templates
Evaluation and Facilitation of Online Discussions in the LLM Era: A Survey
Temporal Scaling Law for Large Language Models
Reframe Your Life Story: Interactive Narrative Therapist and Innovative Moment Assessment with Large Language Models
From Word to World: Evaluate and Mitigate Culture Bias in LLMs via Word Association Test
Mitigating the Privacy Issues in Retrieval-Augmented Generation (RAG) via Pure Synthetic Data
AdaSteer: Your Aligned LLM is Inherently an Adaptive Jailbreak Defender
Large Language Models Meet Knowledge Graphs for Question Answering: Synthesis and Opportunities
TFDP: Token-Efficient Disparity Audits for Autoregressive LLMs via Single-Token Masked Evaluation
Hanfu-Bench: A Multimodal Benchmark on Cross-Temporal Cultural Understanding and Transcreation
MERMAID: Multi-perspective Self-reflective Agents with Generative Augmentation for Emotion Recognition
Personality Vector: Modulating Personality of Large Language Models by Model Merging
Beyond Outlining: Heterogeneous Recursive Planning for Adaptive Long-form Writing with Language Models
Hidden in Plain Sight: Reasoning in Underspecified and Misspecified Scenarios for Multimodal LLMs
PrimeX: A Dataset of Worldview, Opinion, and Explanation
LASER: An LLM-based ASR Scoring and Evaluation Rubric
Improving Zero-shot Sentence Decontextualisation with Content Selection and Planning
Beyond Text: Unveiling Privacy Vulnerabilities in Multi-modal Retrieval-Augmented Generation
Code Execution as Grounded Supervision for LLM Reasoning
Subjective Behaviors and Preferences in LLM: Language of Browsing
Pixels Versus Priors: Controlling Knowledge Priors in Vision-Language Models through Visual Counterfacts
Balcony: A Lightweight Approach to Dynamic Inference of Generative Language Models
Social Genome: Grounded Social Reasoning Abilities of Multimodal Models
Profiler: Black-box AI-generated Text Origin Detection via Context-aware Inference Pattern Analysis
Speech Discrete Tokens or Continuous Features? A Comparative Analysis for Spoken Language Understanding in SpeechLLMs
RAG-Zeval: Enhancing RAG Responses Evaluator through End-to-End Reasoning and Ranking-Based Reinforcement Learning​
Mahānāma: A Unique Testbed for Literary Entity Discovery and Linking
Adaptively profiling models with task elicitation
TactfulToM: Do LLMs have the Theory of Mind ability to understand White Lies?
Don’t Sweat the Small Stuff: Segment-Level Meta-Evaluation Based on Pairwise Difference Correlation
SMART: Simulated Students Aligned with Item Response Theory for Question Difficulty Prediction
HESEIA: A community-based dataset for evaluating social biases in large language models, co-designed in real school settings in Latin America
WebMMU: A Benchmark for Multimodal Multilingual Website Understanding and Code Generation
Analyzing values about gendered language reform in LLMs’ revisions
ALLabel: Three-stage Active Learning for LLM-based Entity Recognition using Demonstration Retrieval
HyperKGR: Knowledge Graph Reasoning in Hyperbolic Space with Graph Neural Network Encoding Symbolic Path
LLaMP: Large Language Model Made Powerful for High-fidelity Materials Knowledge Retrieval
ReSeeding Latent States for Sequential Language Understanding
DPED: Multi-Layer Noise Distillation for Privacy-Preserving Text Embeddings
Identifying & Interactively Refining Ambiguous User Goals for Data Visualization Code Generation
Morpheme Induction for Emergent Language
Stepwise Informativeness Search for Improving LLM Reasoning
Social Good or Scientific Curiosity? Uncovering the Research Framing Behind NLP Artefacts
FairGen: Controlling Sensitive Attributes for Fair Generations in Diffusion Models via Adaptive Latent Guidance
Contra4: Evaluating Contrastive Cross-Modal Reasoning in Audio, Video, Image, and 3D
Proactive Hearing Assistants that Isolate Egocentric Conversations
fLSA: Learning Semantic Structures in Document Collections Using Foundation Models
SafeKey: Amplifying Aha-Moment Insights for Safety Reasoning
HypER: Literature-grounded Hypothesis Generation and Distillation with Provenance
Empowering GraphRAG with Knowledge Filtering and Integration
Interpretable Mnemonic Generation for Kanji Learning via Expectation-Maximization
Refining Attention for Explainable and Noise-Robust Fact-Checking with Transformers
Harmful Prompt Laundering: Jailbreaking LLMs with Abductive Styles and Symbolic Encoding
Pathway to Relevance: How Cross-Encoders Implement a Semantic Variant of BM25
Rewarding the Unlikely: Lifting GRPO Beyond Distribution Sharpening
PhoniTale: Phonologically Grounded Mnemonic Generation for Typologically Distant Language Pairs
Amulet: Putting Complex Multi-Turn Conversations on the Stand with LLM Juries
Exploring Chain-of-Thought Reasoning for Steerable Pluralistic Alignment
CMedCalc-Bench: A Fine-Grained Benchmark for Chinese Medical Calculations in LLM
Evaluating Robustness of Large Audio Language Models to Audio Injection: An Empirical Study
How Far Can LLMs Improve from Experience? Measuring Test-Time Learning Ability in LLMs with Human Comparison
Subtle Risks, Critical Failures: A Framework for Diagnosing Physical Safety of LLMs for Embodied Decision Making
SwiftKV: Fast Prefill-Optimized Inference with Knowledge-Preserving Model Transformation
Co-Eval: Augmenting LLM-based Evaluation with Machine Metrics
Sali4Vid: Saliency-Aware Video Reweighting and Adaptive Caption Retrieval for Dense Video Captioning
Semantic Networks Extracted from Students’ Think-Aloud Data are Correlated with Students’ Learning Performance
Less is More: The Effectiveness of Compact Typological Language Representations
Sparse Activation Editing for Reliable Instruction Following in Narratives
Inceptive Transformers: Enhancing Contextual Representations through Multi-Scale Feature Learning Across Domains and Languages
Causal Tree Extraction from Medical Case Reports: A Novel Task for Experts-like Text Comprehension
OWL: Probing Cross-Lingual Recall of Memorized Texts via World Literature
Enhanced Noun-Noun Compound Interpretation through Textual Enrichment
ICL CIPHERS: Quantifying ‘‘Learning’’ in In-Context Learning via Substitution Ciphers
Corrupted but Not Broken: Understanding and Mitigating the Negative Impacts of Corrupted Data in Visual Instruction Tuning
Memory OS of AI Agent
Rule Discovery for Natural Language Inference Data Generation Using Out-of-Distribution Detection
Jigsaw-Puzzles: From Seeing to Understanding to Reasoning in Vision-Language Models
Definition Generation for Word Meaning Modeling: Monolingual, Multilingual, and Cross-Lingual Perspectives
Language Model Based Text-to-Audio Generation: Anti-Causally Aligned Collaborative Residual Transformers
HELENE: Hessian Layer-wise Clipping and Gradient Annealing for Accelerating Fine-tuning LLM with Zeroth-order Optimization
Zero-shot Multimodal Document Retrieval via Cross-modal Question Generation
From Parameters to Performance: A Data-Driven Study on LLM Structure and Development
Logical Reasoning with Outcome Reward Models for Test-Time Scaling
Speculating LLMs’ Chinese Training Data Pollution from Their Tokens
NovelHopQA: Diagnosing Multi-Hop Reasoning Failures in Long Narrative Contexts
Weights-Rotated Preference Optimization for Large Language Models
The Stepwise Deception: Simulating the Evolution from True News to Fake News with LLM Agents
How to inject knowledge efficiently? Knowledge Infusion Scaling Law for Pre-training Large Language Models
SMEC:Rethinking Matryoshka Representation Learning for Retrieval Embedding Compression
Reverse Prompt Engineering: A Zero-Shot, Genetic Algorithm Approach to Language Model Inversion
DiMo-GUI: Advancing Test-time Scaling in GUI Grounding via Modality-Aware Visual Reasoning
SocioBench: Modeling Human Behavior in Sociological Surveys with Large Language Models
Financial Risk Relation Identification through Dual-view Adaptation
CopySpec: Accelerating LLMs with Speculative Copy-and-Paste
GRASP: Replace Redundant Layers with Adaptive Singular Parameters for Efficient Model Compression
GraphAgent: Agentic Graph Language Assistant
DDO: Dual-Decision Optimization for LLM-Based Medical Consultation via Multi-Agent Collaboration
FedMABench: Benchmarking Mobile GUI Agents on Decentralized Heterogeneous User Data
VLA-Mark: A cross modal watermark for large vision-language alignment models
Sentence Smith: Controllable Edits for Evaluating Text Embeddings
ReasonMed: A 370K Multi-Agent Generated Dataset for Advancing Medical Reasoning
Decoding Dense Embeddings: Sparse Autoencoders for Interpreting and Discretizing Dense Retrieval
UICOMPASS: UI Map Guided Mobile Task Automation via Adaptive Action Generation
Leaky Thoughts: Large Reasoning Models Are Not Private Thinkers
Model Unlearning via Sparse Autoencoder Subspace Guided Projections
ConvSearch-R1: Enhancing Query Reformulation for Conversational Search with Reasoning via Reinforcement Learning
How to Make Large Language Models Generate 100% Valid Molecules?
Exploring Quality and Diversity in Synthetic Data Generation for Argument Mining
Dynamic Jointly Batch Selection for Data Efficient Machine Translation Fine-Tuning
3MDBench: Medical Multimodal Multi-agent Dialogue Benchmark
OpenTuringBench: An Open-Model-based Benchmark and Framework for Machine-Generated Text Detection and Attribution
CRITICTOOL: Evaluating Self-Critique Capabilities of Large Language Models in Tool-Calling Error Scenarios
Pre-trained Language Models Learn Remarkably Accurate Representations of Numbers
Enhancing Large Vision-Language Models with Ultra-Detailed Image Caption Generation
Translate Smart, not Hard: Cascaded Translation Systems with Quality-Aware Deferral
iVISPAR — An Interactive Visual-Spatial Reasoning Benchmark for VLMs
Are LLMs Better than Reported? Detecting Label Errors and Mitigating Their Effect on Model Performance
Detecting Legal Citations in United Kingdom Court Judgments
Large Language Models Badly Generalize across Option Length, Problem Types, and Irrelevant Noun Replacements
Studying the Role of Input-Neighbor Overlap in Retrieval-Augmented Language Models Training Efficiency
Principled Personas: Defining and Measuring the Intended Effects of Persona Prompting on Task Performance
HydraOpt: Navigating the Efficiency-Performance Trade-off of Adapter Merging
Parrot: A Training Pipeline Enhances Both Program CoT and Natural Language CoT for Reasoning
Spec-VLA: Speculative Decoding for Vision-Language-Action Models with Relaxed Acceptance
Leveraging Text-to-Text Transformers as Classifier Chain for Few-Shot Multi-Label Classification
M-Wanda: Improving One-Shot Pruning for Multilingual LLMs
Beyond Hate Speech: NLP’s Challenges and Opportunities in Uncovering Dehumanizing Language
Conflict-Aware Soft Prompting for Retrieval-Augmented Generation
R-CHAR: A Metacognition-Driven Framework for Role-Playing in Large Language Models
Annotating Training Data for Conditional Semantic Textual Similarity Measurement using Large Language Models
When Words Smile: Generating Diverse Emotional Facial Expressions from Text
Improving Online Job Advertisement Analysis via Compositional Entity Extraction
Correlation-Aware Example Selection for In-Context Learning with Nonsymmetric Determinantal Point Processes
Leveraging Cognitive Complexity of Texts for Contextualization in Dense Retrieval
Beyond Online Sampling: Bridging Offline-to-Online Alignment via Dynamic Data Transformation for LLMs
CAVE : Detecting and Explaining Commonsense Anomalies in Visual Environments
Enhancing LLM Language Adaption through Cross-lingual In-Context Pre-training
SemVink: Advancing VLMs’ Semantic Understanding of Optical Illusions via Visual Global Thinking
Order Doesn’t Matter, But Reasoning Does: Training LLMs with Order-Centric Augmentation
Type-Less yet Type-Aware Inductive Link Prediction with Pretrained Language Models
Extracting Linguistic Information from Large Language Models: Syntactic Relations and Derivational Knowledge
Beyond Correctness: Confidence-Aware Reward Modeling for Enhancing Large Language Model Reasoning
TrojanStego: Your Language Model Can Secretly Be A Steganographic Privacy Leaking Agent
Frequency & Compositionality in Emergent Communication
Summarizing Speech: A Comprehensive Survey
CogDual: Enhancing Dual Cognition of LLMs via Reinforcement Learning with Implicit Rule-Based Rewards
Assay2Mol: Large Language Model-based Drug Design Using BioAssay Context
Frame First, Then Extract: A Frame-Semantic Reasoning Pipeline for Zero-Shot Relation Triplet Extraction
MrGuard: A Multilingual Reasoning Guardrail for Universal LLM Safety
TALON: A Multi-Agent Framework for Long-Table Exploration and Question Answering
You Are What You Train: Effects of Data Composition on Training Context-aware Machine Translation Models
Improving Neutral Point-of-View Generation with Data- and Parameter-Efficient RL
Randomized Smoothing Meets Vision-Language Models
PIIvot: A Lightweight NLP Anonymization Framework for Question-Anchored Tutoring Dialogues
Trustworthy Medical Question Answering: An Evaluation-Centric Survey
Unpacking Let Alone: Human-Scale Models Generalize to a Rare Construction in Form but not Meaning
BOUQuET : dataset, Benchmark and Open initiative for Universal Quality Evaluation in Translation
HealthCards: Exploring Text-to-Image Generation as Visual Aids for Healthcare Knowledge Democratizing and Education
When Life Gives You Samples: The Benefits of Scaling up Inference Compute for Multilingual LLMs
Creativity in LLM-based Multi-Agent Systems: A Survey
Context and POS in Action: A Comparative Study of Chinese Homonym Disambiguation in Human and Language Models
Attacking Misinformation Detection Using Adversarial Examples Generated by Language Models
Leveraging Loanword Constraints for Improving Machine Translation in a Low-Resource Multilingual Context
Linguistic Neuron Overlap Patterns to Facilitate Cross-lingual Transfer on Low-resource Languages
Scaling Low-Resource MT via Synthetic Data Generation with LLMs
Tailoring Table Retrieval from a Field-aware Hybrid Matching Perspective
Randomly Removing 50% of Dimensions in Text Embeddings has Minimal Impact on Retrieval and Classification Tasks
Morables: A Benchmark for Assessing Abstract Moral Reasoning in LLMs with Fables
MessIRve: A Large-Scale Spanish Information Retrieval Dataset
AFRIDOC-MT: Document-level MT Corpus for African Languages
Charting the Landscape of African NLP: Mapping Progress and Shaping the Road Ahead
GLIMPSE: Do Large Vision-Language Models Truly Think With Videos or Just Glimpse at Them?
Social Bias in Multilingual Language Models: A Survey
BYOKG-RAG: Multi-Strategy Graph Retrieval for Knowledge Graph Question Answering
Synth-SBDH: A Synthetic Dataset of Social and Behavioral Determinants of Health for Clinical Text
Pun Unintended: LLMs and the Illusion of Humor Understanding
RACCooN: Versatile Instructional Video Editing with Auto-Generated Narratives
Pre-trained Models Perform the Best When Token Distributions Follow Zipf’s Law
Do RAG Systems Really Suffer From Positional Bias?
Aspect-Oriented Summarization for Psychiatric Short-Term Readmission Prediction
Adapting Bias Evaluation to Domain Contexts using Generative Models
Emergent morpho-phonological representations in self-supervised speech models
Multilingual Language Model Pretraining using Machine-translated Data
IntentionFrame: A Semi-Structured, Multi-Aspect Framework for Fine-Grained Conversational Intention Understanding
Video-RTS: Rethinking Reinforcement Learning and Test-Time Scaling for Efficient and Enhanced Video Reasoning
Efficient Compositional Multi-tasking for On-device Large Language Models
Improving Large Language Model Safety with Contrastive Representation Learning
Leveraging What’s Overfixed: Post-Correction via LLM Grammatical Error Overcorrection
Scaling Up Temporal Domain Generalization via Temporal Experts Averaging
LinguaLens: Towards Interpreting Linguistic Mechanisms of Large Language Models via Sparse Auto-Encoder
The Strawberry Problem: Emergence of Character-level Understanding in Tokenized Language Models
Improving the Quality of Web-mined Parallel Corpora of Low-Resource Languages using Debiasing Heuristics
Weaver: Interweaving SQL and LLM for Table Reasoning
ECO Decoding: Entropy-Based Control for Controllability and Fluency in Controllable Dialogue Generation
Investigating the interaction of linguistic and mathematical reasoning in language models using multilingual number puzzles
Unsupervised Concept Vector Extraction for Bias Control in LLMs
Seeing the Same Story Differently: Framing‑Divergent Event Coreference for Computational Framing Analysis
LLMs are Better Than You Think: Label-Guided In-Context Learning for Named Entity Recognition
COUNTDOWN: Contextually Sparse Activation Filtering Out Unnecessary Weights in Down Projection
SimpleDoc: Multi‑Modal Document Understanding with Dual‑Cue Page Retrieval and Iterative Refinement
VLP: Vision-Language Preference Learning for Embodied Manipulation
QG-CoC: Question-Guided Chain-of-Captions for Large Multimodal Models
EGOILLUSION: Benchmarking Hallucinations in Egocentric Video Understanding
MULTIVOX: A Benchmark for Evaluating Voice Assistants for Multimodal Interactions
Do All Autoregressive Transformers Remember Facts the Same Way? A Cross-Architecture Analysis of Recall Mechanisms
Probing Narrative Morals: A New Character-Focused MFT Framework for Use with Large Language Models
Probing and Boosting Large Language Models Capabilities via Attention Heads
A Survey of Link Prediction in N-ary Knowledge Graphs
Multi-Frequency Contrastive Decoding: Alleviating Hallucinations for Large Vision-Language Models
ORPP: Self-Optimizing Role-playing Prompts to Enhance Language Model Capabilities
BrailleLLM: Braille Instruction Tuning with Large Language Models for Braille Domain Tasks
MAviS: A Multimodal Conversational Assistant For Avian Species
Refining Text Generation for Realistic Conversational Recommendation via Direct Preference Optimization
Large Language Models Threaten Language’s Epistemic and Communicative Foundations
Detecting Knowledge Boundary of Vision Large Language Models by Sampling-Based Inference
Multi-view-guided Passage Reranking with Large Language Models
Disentangling Subjectivity and Uncertainty for Hate Speech Annotation and Modeling using Gaze
VoiceBBQ: Investigating Effect of Content and Acoustics in Social Bias of Spoken Language Model
Explaining Differences Between Model Pairs in Natural Language through Sample Learning
Compound AI Systems Optimization: A Survey of Methods, Challenges, and Future Directions
A Multi-Level Benchmark for Causal Language Understanding in Social Media Discourse
Causal Representation Learning from Multimodal Clinical Records under Non-Random Modality Missingness
XLQA: A Benchmark for Locale-Aware Multilingual Open-Domain Question Answering
Transformer-Based Temporal Information Extraction and Application: A Review
How to Protect Yourself from 5G Radiation? Investigating LLM Responses to Implicit Misinformation
AmpleHate: Amplifying the Attention for Versatile Implicit Hate Detection
Can Large Language Models Act as Ensembler for Multi-GNNs?
Agent-to-Agent Theory of Mind: Testing Interlocutor Awareness among Large Language Models
From Charts to Fair Narratives: Uncovering and Mitigating Geo-Economic Biases in Chart-to-Text
Real-time Ad Retrieval via LLM-generative Commercial Intention for Sponsored Search Advertising
Toward Efficient Sparse Autoencoder-Guided Steering for Improved In-Context Learning in Large Language Models
CLMTracing: Black-box User-level Watermarking for Code Language Model Tracing
The Good, the Bad and the Constructive: Automatically Measuring Peer Review’s Utility for Authors
Evolving Chinese Spelling Correction with Corrector-Verifier Collaboration
M2Edit: Locate and Edit Multi-Granularity Knowledge in Multimodal Large Language Model
Do LLMs Behave as Claimed? Investigating How LLMs Follow Their Own Claims using Counterfactual Questions
Multilingual vs Crosslingual Retrieval of Fact-Checked Claims: A Tale of Two Approaches
How Much Do LLMs Hallucinate across Languages? On Realistic Multilingual Estimation of LLM Hallucination
LiTransProQA: An LLM-based Literary Translation Evaluation Metric with Professional Question Answering
Improving Handshape Representations for Sign Language Processing: A Graph Neural Network Approach
Instructing Large Language Models for Low-Resource Languages: A Systematic Study for Basque
SOCIAL SCAFFOLDS: A Generalization Framework for Social Understanding Tasks
Beyond A Single AI Cluster: A Survey of Decentralized LLM Training
Can LLM Agents Maintain a Persona in Discourse?
Iterative Multilingual Spectral Attribute Erasure
TinySQL: A Progressive Text-to-SQL Dataset for Mechanistic Interpretability Research
SCRIBE: Structured Chain Reasoning for Interactive Behaviour Explanations using Tool Calling
Logit Space Constrained Fine-Tuning for Mitigating Hallucinations in LLM-Based Recommender Systems
PACHAT: Persona-Aware Speech Assistant for Multi-party Dialogue
Reasoning-to-Defend: Safety-Aware Reasoning Can Defend Large Language Models from Jailbreaking
Graph-Guided Textual Explanation Generation Framework
The Validation Gap: A Mechanistic Analysis of How Language Models Compute Arithmetic but Fail to Validate It
A Causal Lens for Evaluating Faithfulness Metrics
Sequential-NIAH: A Needle-In-A-Haystack Benchmark for Extracting Sequential Needles from Long Contexts
FISTAPruner: Layer-wise Post-training Pruning for Large Language Models
Do LLMs Encode Frame Semantics? Evidence from Frame Identification
StepER: Step-wise Knowledge Distillation for Enhancing Reasoning Ability in Multi-Step Retrieval-Augmented Language Models
How Does DPO Reduce Toxicity? A Mechanistic Neuron-Level Analysis
It’s All About In-Context Learning! Teaching Extremely Low-Resource Languages to LLMs
Where to show Demos in Your Prompt: A Positional Bias of In-Context Learning
Multilingual Pretraining for Pixel Language Models
MetaFaith: Faithful Natural Language Uncertainty Expression in LLMs
Machine-generated text detection prevents language model collapse
Data-Efficient Hate Speech Detection via Cross-Lingual Nearest Neighbor Retrieval with Limited Labeled Data
V-VAE: A Variational Auto Encoding Framework Towards Fine-Grained Control over Human-Like Chat
Mixture of Languages: Improved Multilingual Encoders Through Language Grouping
Too Helpful, Too Harmless, Too Honest or Just Right?
Cardiverse: Harnessing LLMs for Novel Card Game Prototyping
Assessing effective de-escalation of crisis conversations using transformer-based models and trend statistics
Measuring and Mitigating Media Outlet Name Bias in Large Language Models
The Good, the Bad, and the Debatable: A Survey on the Impacts of Data for In-Context Learning
Where Confabulation Lives: Latent Feature Discovery in LLMs
Analysing Chain of Thought Dynamics: Active Guidance or Unfaithful Post-hoc Rationalisation?
Playpen: An Environment for Exploring Learning From Dialogue Game Feedback
GenLink: Generation-Driven Schema-Linking via Multi-Model Learning for Text-to-SQL
TSVer: A Benchmark for Fact Verification Against Time-Series Evidence
Cross-MoE: An Efficient Temporal Prediction Framework Integrating Textual Modality
Sparse Autoencoder Features for Classifications and Transferability
KGE Calibrator: An Efficient Probability Calibration Method of Knowledge Graph Embedding Models for Trustworthy Link Prediction
LCES: Zero-shot Automated Essay Scoring via Pairwise Comparisons Using Large Language Models
The Arabic Generality Score: Another Dimension of Modeling Arabic Dialectness
Lemmatization as a Classification Task: Results from Arabic across Multiple Genres
A Comprehensive Framework to Operationalize Social Stereotypes for Responsible AI Evaluations
Correct-Detect: Balancing Performance and Ambiguity Through the Lens of Coreference Resolution in LLMs
GRAID: Synthetic Data Generation with Geometric Constraints and Multi-Agentic Reflection for Harmful Content Detection
LaMDAgent: An Autonomous Framework for Post-Training Pipeline Optimization via LLM Agents
Finetuning LLMs for Human Behavior Prediction in Social Science Experiments
How Private are Language Models in Abstractive Summarization?
Expectation Preference Optimization: Reliable Preference Estimation for Improving the Reasoning Capability of Large Language Models
Split-Merge: Scalable and Memory-Efficient Merging of Expert LLMs
Model Consistency as a Cheap yet Predictive Proxy for LLM Elo Scores
Plutus: Benchmarking Large Language Models in Low-Resource Greek Finance
TaxoAlign: Scholarly Taxonomy Generation Using Language Models
DiNaM: Disinformation Narrative Mining with Large Language Models
VeriLocc: End-to-End Cross-Architecture Register Allocation via LLM
MemeIntel: Explainable Detection of Propagandistic and Hateful Memes
FLUID QA: A Multilingual Benchmark for Figurative Language Usage in Dialogue across English, Chinese, and Korean
Structured Moral Reasoning in Language Models: A Value-Grounded Evaluation Framework
VerIF: Verification Engineering for Reinforcement Learning in Instruction Following
UNCLE: Benchmarking Uncertainty Expressions in Long-Form Generation
Enhancing Study-Level Inference from Clinical Trial Papers via Reinforcement Learning-Based Numeric Reasoning
Context-aware Biases for Length Extrapolation
AutoSDT: Scaling Data-Driven Discovery Tasks Toward Open Co-Scientists
Finding your MUSE: Mining Unexpected Solutions Engine
Quantized but Deceptive? A Multi-Dimensional Truthfulness Evaluation of Quantized LLMs
Leveraging Knowledge Graph-Enhanced LLMs for Context-Aware Medical Consultation
Reflective Agreement: Combining Self-Mixture of Agents with a Sequence Tagger for Robust Event Extraction
Simple Yet Effective: An Information-Theoretic Approach to Multi-LLM Uncertainty Quantification
Exploring morphology-aware tokenization: A case study on Spanish language modeling
Studying Rhetorically Ambiguous Questions
Estimating LLM Consistency: A User Baseline vs Surrogate Metrics
Are Vision-Language Models Safe in the Wild? A Meme-Based Benchmark Study
Improving Rule-based Reasoning in LLMs using Neurosymbolic Representations
Can LLMs Extract Frame-Semantic Arguments?
Accelerated Test-Time Scaling with Model-Free Speculative Sampling
Enhancing RLHF with Human Gaze Modeling
Mapping semantic networks to Dutch word embeddings as a diagnostic tool for cognitive decline
CausalVLBench: Benchmarking Visual Causal Reasoning in Large Vision-Language Models
Implicit Behavioral Alignment of Language Agents in High-Stakes Crowd Simulations
Are Language Models Consequentialist or Deontological Moral Reasoners?
PatentScore: Multi-dimensional Evaluation of LLM-Generated Patent Claims
All for One: LLMs Solve Mental Math at the Last Token With Information Transferred From Other Tokens
A Position Paper on the Automatic Generation of Machine Learning Leaderboards
SimMark: A Robust Sentence-Level Similarity-Based Watermarking Algorithm for Large Language Models
SERVAL: Surprisingly Effective Zero-Shot Visual Document Retrieval Powered by Large Vision and Language Models
Meta-Semantics Augmented Few-Shot Relational Learning
ProLongVid: A Simple but Strong Baseline for Long-context Video Instruction Tuning
ModelCitizens: Representing Community Voices in Online Safety
UnifiedVisual: A Framework for Constructing Unified Vision-Language Datasets
The Pursuit of Empathy: Evaluating Small Language Models for PTSD Dialogue Support
Is Cognition Consistent with Perception? Assessing and Mitigating Multimodal Knowledge Conflicts in Document Understanding
AutoCT: Automating Interpretable Clinical Trial Prediction with LLM Agents
MMDocIR: Benchmarking Multimodal Retrieval for Long Documents
Program of Thoughts for Financial Reasoning: Leveraging Dynamic In-Context Examples and Generative Retrieval
Waste-Bench: A Comprehensive Benchmark for Evaluating VLLMs in Cluttered Environments
Demystifying Domain-adaptive Post-training for Financial LLMs
HICode: Hierarchical Inductive Coding with LLMs
Cacheback: Speculative Decoding With Nothing But Cache
MA-DPR: Manifold-aware Distance Metrics for Dense Passage Retrieval
LLM-Guided Co-Training for Text Classification
LeanK: Learnable K Cache Channel Pruning for Efficient Decoding
DELOC: Document Element Localizer
NL2Lean: Translating Natural Language into Lean 4 through Multi-Aspect Reinforcement Learning
A Multilingual, Culture-First Approach to Addressing Misgendering in LLM Applications
X-CoT: Explainable Text-to-Video Retrieval via LLM-based Chain-of-Thought Reasoning
Token-level Proximal Policy Optimization for Query Generation
Prior Prompt Engineering for Reinforcement Fine-Tuning
Beyond WER: Probing Whisper’s Sub‑token Decoder Across Diverse Language Resource Levels
ThinkTuning: Instilling Cognitive Reflections without Distillation
$\texttt{Droid}$: A Resource Suite for AI-Generated Code Detection
LoRACoE: Improving Large Language Model via Composition-based LoRA Expert
Same Question, Different Words: A Latent Adversarial Framework for Prompt Robustness
Pluralistic Alignment for Healthcare: A Role-Driven Framework
Flexible-length Text Infilling for Discrete Diffusion Models
Beyond the Leaderboard: Understanding Performance Disparities in Large Language Models via Model Diffing
Explicit Learning and the LLM in Machine Translation
Towards Language-Agnostic STIPA: Universal Phonetic Transcription to Support Language Documentation at Scale
Beyond Pairwise: Global Zero-shot Temporal Graph Generation
“Feels Feminine to Me”: Understanding Perceived Gendered Style through Human Annotations
RALS: Resources and Baselines for Romanian Automatic Lexical Simplification
How Do Social Bots Participate in Misinformation Spread? A Comprehensive Dataset and Analysis
Are Stereotypes Leading LLMs’ Zero-Shot Stance Detection ?
Multi-Modal Framing Analysis of News
TempParaphraser: “Heating Up” Text to Evade AI-Text Detection through Paraphrasing
ComicScene154: A Scene Dataset for Comic Analysis
MedLinkDE – MedDRA Entity Linking for German with Guided Chain of Thought Reasoning
HookMoE: A learnable performance compensation strategy of Mixture-of-Experts for LLM inference acceleration
Cross-Document Cross-Lingual NLI via RST-Enhanced Graph Fusion and Interpretability Prediction
3R: Enhancing Sentence Representation Learning via Redundant Representation Reduction
When Big Models Train Small Ones: Label-Free Model Parity Alignment for Efficient Visual Question Answering using Small VLMs
ProReason: Multi-Modal Proactive Reasoning with Decoupled Eyesight and Wisdom
Extractive Fact Decomposition for Interpretable Natural Language Inference in one Forward Pass
Structure-Conditional Minimum Bayes Risk Decoding
Label Set Optimization via Activation Distribution Kurtosis for Zero-Shot Classification with Generative Models
The Transfer Neurons Hypothesis: An Underlying Mechanism for Language Latent Space Transitions in Multilingual LLMs
VEHME: A Vision-Language Model For Evaluating Handwritten Mathematics Expressions
All Roads Lead to Rome: Graph-Based Confidence Estimation for Large Language Model Reasoning
SEMMA: A Semantic Aware Knowledge Graph Foundation Model
Text2Vis: A Challenging and Diverse Benchmark for Generating Multimodal Visualizations from Text
Predicting Prosodic Boundaries for Children’s Texts
Enhancing Logical Reasoning in Language Models via Symbolically-Guided Monte Carlo Process Supervision
Can Large Language Models Outperform Non-Experts in Poetry Evaluation? A Comparative Study Using the Consensual Assessment Technique
Beyond Human Labels: A Multi-Linguistic Auto-Generated Benchmark for Evaluating Large Language Models on Resume Parsing
Orthogonal Finetuning Made Scalable
AIR: Complex Instruction Generation via Automatic Iterative Refinement
SQUiD: Synthesizing Relational Databases from Unstructured Text
RAG+: Enhancing Retrieval-Augmented Generation with Application-Aware Reasoning
Rapid Word Learning Through Meta In-Context Learning
EuroGEST: Investigating gender stereotypes in multilingual language models
How Persuasive Is Your Context?
The Medium Is Not the Message: Deconfounding Document Embeddings via Linear Concept Erasure
Measuring scalar constructs in social science with LLMs
Text Detoxification: Data Efficiency, Semantic Preservation and Model Generalization
Not What the Doctor Ordered: Surveying LLM-based De-identification and Quantifying Clinical Information Loss
Reasoning under Uncertainty: Efficient LLM Inference via Unsupervised Confidence Dilution and Convergent Adaptive Sampling
Africa Health Check: Probing Cultural Bias in Medical LLMs
Assumed Identities: Quantifying Gender Bias in Machine Translation of Gender-Ambiguous Occupational Terms
REVIVING YOUR MNEME: Predicting The Side Effects of LLM Unlearning and Fine-Tuning via Sparse Model Diffing
ToM-SSI: Evaluating Theory of Mind in Situated Social Interactions
Recursive Training Loops in LLMs: How training data properties modulate distribution shift in generated data?
Detecting LLM Hallucination Through Layer-wise Information Deficiency: Analysis of Ambiguous Prompts and Unanswerable Questions
Extending Automatic Machine Translation Evaluation to Book-Length Documents
MedFact: A Large-scale Chinese Dataset for Evidence-based Medical Fact-checking of LLM Responses
VideoPASTA: 7K Preference Pairs That Matter for Video-LLM Alignment
Do LLMs Adhere to Label Definitions? Examining Their Receptivity to External Label Definitions
Group-Aware Reinforcement Learning for Output Diversity in Large Language Models
Model-Based Ranking of Source Languages for Zero-Shot Cross-Lingual Transfer
PruneCD: Contrasting Pruned Self Model to Improve Decoding Factuality
Crisp: Cognitive Restructuring of Negative Thoughts through Multi-turn Supportive Dialogues
The Impact of Language Mixing on Bilingual LLM Reasoning
VISaGE: Understanding Visual Generics and Exceptions
Stronger Baselines for Retrieval-Augmented Generation with Long-Context Language Models
Discursive Circuits: How Do Language Models Understand Discourse Relations?
Making VLMs More Robot-Friendly: Self-Critical Distillation of Low-Level Procedural Reasoning
ThinkSLM: Towards Reasoning in Small Language Models
MAgICoRe: Multi-Agent, Iterative, Coarse-to-Fine Refinement for Reasoning
Batched Self-Consistency Improves LLM Relevance Assessment and Ranking
SemCSE: Semantic Contrastive Sentence Embeddings Using LLM-Generated Summaries For Scientific Abstracts
Controlled Generation for Private Synthetic Text
Towards AI-Assisted Psychotherapy: Emotion-Guided Generative Interventions
From Shortcuts to Balance: Attribution Analysis of Speech-Text Feature Utilization in Distinguishing Original from Machine-Translated Texts
DEBATE, TRAIN, EVOLVE: Self‑Evolution of Language Model Reasoning
From Chat Logs to Collective Insights: Aggregative Question Answering
A Text-Based Recommender System that Leverages Explicit Affective State Preferences
CARE: Multilingual Human Preference Learning for Cultural Awareness
Multilingual Dialogue Generation and Localization with Dialogue Act Scripting
SUE: Sparsity-based Uncertainty Estimation via Sparse Dictionary Learning
Planning-Aware Code Infilling via Horizon-Length Prediction
SinhalaMMLU: A Comprehensive Benchmark for Evaluating Multitask Language Understanding in Sinhala
OG-RAG: Ontology-grounded retrieval-augmented generation for large language models
Convergence and Divergence of Language Models under Different Random Seeds
Analyzing and Modeling LLM Response Lengths with Extreme Value Theory: Anchoring Effects and Hybrid Distributions
Language Models Identify Ambiguities and Exploit Loopholes
Benchmarking LLMs for Translating Classical Chinese Poetry: Evaluating Adequacy, Fluency, and Elegance
AraEval: An Arabic Multi-Task Evaluation Suite for Large Language Models
QUIDS: Query Intent Description for Exploratory Search via Dual Space Modeling
A Systematic Survey of Automatic Prompt Optimization Techniques
Threading the Needle: Reweaving Chain-of-Thought Reasoning to Explain Human Label Variation
MemInsight: Autonomous Memory Augmentation for LLM Agents
Breaking the Noise Barrier: LLM-Guided Semantic Filtering and Enhancement for Multi-Modal Entity Alignment
ImpliRet: Benchmarking the Implicit Fact Retrieval Challenge
No Need for Explanations: LLMs can implicitly learn from mistakes in-context
MoVa: Towards Generalizable Classification of Human Morals and Values
GUI-Bee: Align GUI Action Grounding to Novel Environments via Autonomous Exploration
Revealing and Mitigating the Challenge of Detecting Character Knowledge Errors in LLM Role-Playing
Taking Notes Brings Focus? Towards Multi-Turn Multimodal Dialogue Learning
Graph-Based Multi-Trait Essay Scoring
Benchmarking LLMs on Semantic Overlap Summarization
N-CORE: N-View Consistency Regularization for Disentangled Representation Learning in Nonverbal Vocalizations
Probability Distribution Collapse: A Critical Bottleneck to Compact Unsupervised Neural Grammar Induction
Spatial Layouts in News Homepages Capture Human Preferences
KRETA: A Benchmark for Korean Reading and Reasoning in Text-Rich VQA Attuned to Diverse Visual Contexts
ReflAct: World-Grounded Decision Making in LLM Agents via Goal-State Reflection
CompassVerifier: A Unified and Robust Verifier for LLMs Evaluation and Outcome Reward
A Knowledge-driven Adaptive Collaboration of LLMs for Enhancing Medical Decision-making
Castle: Causal Cascade Updates in Relational Databases with Large Language Models
Idiosyncratic Versus Normative Modeling of Atypical Speech Recognition: Dysarthric Case Studies
NESTFUL: A Benchmark for Evaluating LLMs on Nested Sequences of API Calls
Benchmarking and Mitigating MCQA Selection Bias of Large Vision-Language Models
Can Large Language Models Unlock Novel Scientific Research Ideas?
Word Salad Chopper: Reasoning Models Waste A Ton Of Decoding Budget On Useless Repetitions, Self-Knowingly
DIWALI - Diversity and Inclusivity aWare cuLture specific Items for India: Dataset and Assessment of LLMs for Cultural Text Adaptation in Indian Context
SYNC: A Synthetic Long-Context Understanding Benchmark for Controlled Comparisons of Model Capabilities
OpenNER 1.0: Standardized Open-Access Named Entity Recognition Datasets in 50+ Languages
Mondrian: A Framework for Logical Abstract (Re)Structuring
Case-Based Decision-Theoretic Decoding with Quality Memories
PRIME: Large Language Model Personalization with Cognitive Dual-Memory and Personalized Thought Process
Mechanisms vs. Outcomes: Probing for Syntax Fails to Explain Performance on Targeted Syntactic Evaluations
Image Difference Captioning via Adversarial Preference Optimization
seqBench: A Tunable Benchmark to Quantify Sequential Reasoning Limits of LLMs
NormGenesis: Multicultural Dialogue Generation via Exemplar-Guided Social Norm Modeling and Violation Recovery
SATBench: Benchmarking LLMs’ Logical Reasoning via Automated Puzzle Generation from SAT Formulas
Data Descriptions from Large Language Models with Influence Estimation
EquiBench: Benchmarking Large Language Models’ Reasoning about Program Semantics via Equivalence Checking
MicroEdit: Neuron-level Knowledge Disentanglement and Localization in Lifelong Model Editing
Do Large Language Models Understand Word Senses?
Diverse, not Short: A Length-Controlled Data Selection Strategy for Improving Response Diversity of Language Models
Uncovering the Bigger Picture: Comprehensive Event Understanding Via Diverse News Retrieval
Personalized LLM Decoding via Contrasting Personal Preference
The Missing Parts: Augmenting Fact Verification with Half Truth Detection
Toward Machine Translation Literacy: How Lay Users Perceive and Rely on Imperfect Translations
Personalization up to a Point: Why Personalized Content Moderation Needs Boundaries, and How We Can Enforce Them
MPCG: Multi-Round Persona-Conditioned Generation for Modeling the Evolution of Misinformation with LLMs
LiTEx: A Linguistic Taxonomy of Explanations for Understanding Within-Label Variation in Natural Language Inference
LiteraryQA: Towards Effective Evaluation of Long-document Narrative QA
FillerSpeech: Towards Human-Like Text-to-Speech Synthesis with Filler Insertion and Filler Style Control
Multi-LMentry: Can Multilingual LLMs Solve Elementary Tasks Across Languages?
Lookahead Q-Cache: Achieving More Consistent KV Cache Eviction via Pseudo Query
PerspectiveMod: A Perspectivist Resource for Deliberative Moderation
LoCt-Instruct: An Automatic Pipeline for Constructing Datasets of Logical Continuous Instructions
CodeSSM: Towards State Space Models for Code Understanding
EduAdapt: A Question Answer Benchmark Dataset for Evaluating Grade-Level Adaptability in LLMs
xCoRe: Cross-context Coreference Resolution
Retrieval-Augmented Generation with Estimation of Source Reliability
NitiBench: Benchmarking LLM Frameworks on Thai Legal Question Answering Capabilities
From Input Perception to Predictive Insight: Modeling Model Blind Spots Before They Become Errors
$\mathrm{Wojood^{Relations}}$: Arabic Relation Extraction Corpus and Modeling
Conflicting Needles in a Haystack: How LLMs behave when faced with contradictory information
Towards Event Extraction with Massive Types: LLM-based Collaborative Annotation and Partitioning Extraction
Liaozhai through the Looking-Glass: On Paratextual Explicitation of Culture-Bound Terms in Machine Translation
Concept-pedia: a Wide-coverage Semantically-annotated Multimodal Dataset
RAED: Retrieval-Augmented Entity Description Generation for Emerging Entity Linking and Disambiguation
Personalized Language Models via Privacy-Preserving Evolutionary Model Merging
Aligning Text/Speech Representations from Multimodal Models with MEG Brain Activity During Listening
STARQA: A Question Answering Dataset for Complex Analytical Reasoning over Structured Databases
Slim-SC: Thought Pruning for Efficient Scaling with Self-Consistency
Long Chain-of-Thought Fine-tuning via Understanding-to-Reasoning Transition
Exploring Large Language Models for Detecting Mental Disorders
Efficient Real-time Refinement of Language Model Text Generation
Reward-Weighted Sampling: Enhancing Non-Autoregressive Characteristics in Masked Diffusion LLMs
AI Argues Differently: Distinct Argumentative and Linguistic Patterns of LLMs in Persuasive Contexts
TounsiBench: Benchmarking Large Language Models for Tunisian Arabic
Moral Framing in Politics (MFiP): A new resource and models for moral framing
ReDepress: A Cognitive Framework for Detecting Depression Relapse from Social Media
iKnow-audio: Integrating Knowledge Graphs with Audio-Language Models
EduVidQA: Generating and Evaluating Long-form Answers to Student Questions based on Lecture Videos
The Illusion of Progress: Re-evaluating Hallucination Detection in LLMs
Turning Logic Against Itself: Probing Model Defenses Through Contrastive Questions
CHURRO: Making History Readable with an Open-Weight Large Vision-Language Model for High-Accuracy, Low-Cost Historical Text Recognition
Towards Author-informed NLP: Mind the Social Bias
Detecting Corpus-Level Knowledge Inconsistencies in Wikipedia with Large Language Models
Leveraging Multilingual Training for Authorship Representation: Enhancing Generalization across Languages and Domains
DrFrattn: Directly Learn Adaptive Policy from Attention for Simultaneous Machine Translation
The Sound of Syntax: Finetuning and Comprehensive Evaluation of Language Models for Speech Pathology
NormXLogit: The Head-on-Top Never Lies
Doc2Chart: Intent-Driven Zero-Shot Chart Generation from Documents
Breaking Agents: Compromising Autonomous LLM Agents Through Malfunction Amplification
FoREST: Frame of Reference Evaluation in Spatial Reasoning Tasks
Multilinguality Does not Make Sense: Investigating Factors Behind Zero-Shot Cross-Lingual Transfer in Sense-Aware Tasks
Translating Domain-Specific Terminology in Typologically-Diverse Languages: A Study in Tax and Financial Education
Train It and Forget It: Merge Lists are Unnecessary for BPE Inference in Language Models
Spectral Scaling Laws in Language Models: \ emph{How Effectively Do Feed-Forward Networks Use Their Latent Space?}
TLUE: A Tibetan Language Understanding Evaluation Benchmark
Retrieving Support to Rank Answers in Open-Domain Question Answering
Trojsten Benchmark: Evaluating LLM Problem-Solving in Slovak STEM Competition Problems
BRSpeech-DF: A Deep Fake Synthetic Speech Dataset for Portuguese Zero-Shot TTS
A Simple Yet Effective Method for Non-Refusing Context Relevant Fine-grained Safety Steering in LLMs
Statistical and Neural Methods for Hawaiian Orthography Modernization
so much depends / upon / a whitespace: Why Whitespace Matters for Poets and LLMs
Certified Mitigation of Worst-Case LLM Copyright Infringement
Quantifying Logical Consistency in Transformers via Query-Key Alignment
SimulatorArena: Are User Simulators Reliable Proxies for Multi-Turn Evaluation of AI Assistants?
CourtReasoner: Can LLM Agents Reason Like Judges?
Not Your Typical Government Tipline: LLM-Assisted Routing of Environmental Protection Agency Citizen Tips
Retracing the Past: LLMs Emit Training Data When They Get Lost
Layer-wise Minimal Pair Probing Reveals Contextual Grammatical-Conceptual Hierarchy in Speech Representations
Current Semantic-change Quantification Methods Struggle with Semantic Change Discovery in the Wild
Evaluating Large Language Models for Detecting Antisemitism
D-RAG: Differentiable Retrieval-Augmented Generation for Knowledge Graph Question Answering
Towards Robust Mathematical Reasoning
Table-LLM-Specialist: Language Model Specialists for Tables using Iterative Fine-tuning
Introducing Spotlight: A Novel Approach for Generating Captivating Key Information from Documents
Argument Summarization and its Evaluation in the Era of Large Language Models
Computational Analysis of Conversation Dynamics through Participant Responsivity
AMQ: Enabling AutoML for Mixed-precision Weight-Only Quantization of Large Language Models
Beyond Averages: Learning with Annotator Disagreement in STS
Dipper: Diversity in Prompts for Producing Large Language Model Ensembles in Reasoning Tasks
Constrained Non-negative Matrix Factorization for Guided Topic Modeling of Minority Topics
Which Word Orders Facilitate Length Generalization in LMs? An Investigation with GCG-Based Artificial Languages
Training compute-optimal transformer encoder models
Mind the Blind Spots: A Focus-Level Evaluation Framework for LLM Reviews
Seeing Through Words, Speaking Through Pixels: Deep Representational Alignment Between Vision and Language Models
Unconditional Truthfulness: Learning Unconditional Uncertainty of Large Language Models
Chinese Toxic Language Mitigation via Sentiment Polarity Consistent Rewrites
A Head to Predict and a Head to Question: Pre-trained Uncertainty Quantification Heads for Hallucination Detection in LLM Outputs
Generative or Discriminative? Revisiting Text Classification in the Era of Transformers
Measuring Chain of Thought Faithfulness by Unlearning Reasoning Steps
LingGym: How Far Are LLMs from Thinking Like Field Linguists?
MiCRo: Mixture Modeling and Context-aware Routing for Personalized Preference Learning
Autoformalization in the Wild: Assessing LLMs on Real-World Mathematical Definitions
InterIDEAS: Philosophical Intertextuality via LLMs
Infini-gram mini: Exact n-gram Search at the Internet Scale with FM-Index
Causal Interventions Reveal Shared Structure Across English Filler–Gap Constructions
Mind the Value-Action Gap: Do LLMs Act in Alignment with Their Values?
AccessEval: Benchmarking Disability Bias in Large Language Models
DiscoSG: Towards Discourse-Level Text Scene Graph Parsing through Iterative Graph Refinement